fips,year,month,day,cd_distance,cd_usercnt,sd_distance,sd_usercnt,cd_sd_weighted_mean_distance,cd_sd_usercnt
AL,2020,1,1,33.46465471,1448,30.0767667732,1565,31.7049319682,3013
AL,2020,1,2,26.62936871,1489,27.9995633188,1374,27.2869472613,2863
AL,2020,1,3,19.80268245,1439,28.54256875,1600,24.404136244,3039
AL,2020,1,4,22.49639123,1380,31.7496703297,1456,27.2470168891,2836
AL,2020,1,5,26.34914674,1465,26.467794836,1433,26.4078157261,2898
AL,2020,1,6,21.89696114,1517,27.2430466185,1523,24.5752796215,3040
AL,2020,1,7,16.79442746,1511,29.8287229862,1527,23.345898582,3038
AL,2020,1,8,13.89403766,1595,24.1675899743,1556,18.9672358196,3151
AL,2020,1,9,17.90616602,1638,23.1666706803,1661,20.5547559687,3299
AL,2020,1,10,18.46369775,1555,25.288116208,1635,21.9614796242,3190
AL,2020,1,11,17.39865946,1589,19.3978086237,1693,18.4299085563,3282
AL,2020,1,12,20.63396655,1611,21.2358327759,1495,20.9236606929,3106
AL,2020,1,13,12.98917003,1771,19.7081294182,1839,16.411930782,3610
AL,2020,1,14,12.009791,1340,25.0894549627,1743,19.4044891145,3083
AL,2020,1,15,11.41625001,1208,16.8357219251,1122,14.0259699623,2330
AL,2020,1,16,18.0807064,1543,21.1041904762,1470,19.5558214322,3013
AL,2020,1,17,21.35423725,1534,28.83130625,1600,25.1715028531,3134
AL,2020,1,18,20.0459347,1439,23.2526357616,1510,21.6878874308,2949
AL,2020,1,19,25.22867351,1455,22.4309123055,1414,23.8497838819,2869
AL,2020,1,20,23.11321834,1594,25.979135101,1584,24.5416677262,3178
AL,2020,1,21,14.39998807,1679,23.4129935559,1707,18.943756636,3386
AL,2020,1,22,15.62951576,1652,23.2416933097,1689,19.4777551738,3341
AL,2020,1,23,20.34577221,1606,24.656143117,1649,22.5294286234,3255
AL,2020,1,24,21.32850833,1562,34.6422278803,1571,28.0044909069,3133
AL,2020,1,25,24.08664227,1635,27.7749458943,1571,25.8939800722,3206
AL,2020,1,26,20.11535693,1555,30.0229775943,1696,25.2840203095,3251
AL,2020,1,27,13.01462101,1504,22.2426293706,1430,17.5122528967,2934
AL,2020,1,28,15.08014826,1551,26.5852377892,1556,20.8419504188,3107
AL,2020,1,29,12.84514452,1522,21.8990385873,1529,17.3824778628,3051
AL,2020,1,30,15.98818954,1541,23.4964731586,1602,19.8151925171,3143
AL,2020,1,31,24.71575072,1532,26.1769908257,1635,25.4701326502,3167
AL,2020,2,1,21.57471846,1545,34.4799319728,1617,28.1742536435,3162
AL,2020,2,2,16.59194521,1023,28.9917848259,1608,24.1704104712,2631
AL,2020,2,3,16.75731976,929,17.2139408284,845,16.9748196488,1774
AL,2020,2,4,12.04190508,1475,21.7392673993,1365,16.7027852088,2840
AL,2020,2,5,11.26631965,1614,23.8098344017,1872,18.0022518402,3486
AL,2020,2,6,20.62116634,763,24.2174663073,1484,22.9962927981,2247
AL,2020,2,7,15.11429634,817,9.19204355109,597,12.6138826802,1414
AL,2020,2,8,20.12370317,1415,26.108287037,1512,23.2151588608,2927
AL,2020,2,9,21.43293868,1334,24.5200641026,1404,23.0159642802,2738
AL,2020,2,10,9.578149872,1481,20.6783263305,1428,15.0271192714,2909
AL,2020,2,11,8.589323019,1418,23.7249868074,1516,16.4099318476,2934
AL,2020,2,12,12.18833895,1499,19.3176349432,1408,15.6414000984,2907
AL,2020,2,13,22.79436881,1632,24.0881168428,1609,23.4366522363,3241
AL,2020,2,14,20.38704832,1467,32.1517097171,1626,26.5717684725,3093
AL,2020,2,15,19.0144535,1345,27.545306685,1451,23.4415879676,2796
AL,2020,2,16,22.1480388,1392,26.8280825959,1356,24.4574053892,2748
AL,2020,2,17,17.25319723,1567,22.0957702703,1480,19.6053495436,3047
AL,2020,2,18,12.22796002,1603,23.2167976804,1552,17.6335625712,3155
AL,2020,2,19,13.42911912,1646,24.0926042908,1678,18.8121901539,3324
AL,2020,2,20,21.59320672,1606,25.0393201483,1618,23.3226767966,3224
AL,2020,2,21,24.28915722,1519,29.6272930355,1522,26.9608582102,3041
AL,2020,2,22,20.08916619,1475,28.0348429319,1910,24.5725465673,3385
AL,2020,2,23,23.16751815,1511,26.8236078965,1469,24.9697986324,2980
AL,2020,2,24,16.50680612,1625,25.1526902537,1498,20.6539513112,3123
AL,2020,2,25,19.01928965,1633,23.8756776119,1675,21.4783131797,3308
AL,2020,2,26,18.67154998,1613,25.6405053191,1504,22.0341771311,3117
AL,2020,2,27,21.58624836,1570,22.4256999372,1593,22.0090262173,3163
AL,2020,2,28,23.78508763,1425,32.3789285714,1568,28.2873070073,2993
AL,2020,2,29,25.58590254,1396,28.0371285809,1501,26.8559371577,2897
AL,2020,3,1,26.88146716,1445,36.7949535382,1399,31.7580379909,2844
AL,2020,3,2,15.45692456,1603,29.1191432396,1494,22.0476106134,3097
AL,2020,3,3,13.75300312,1615,24.9180034722,1728,19.5242028235,3343
AL,2020,3,4,15.03363644,1617,22.7754301403,1639,18.9306879986,3256
AL,2020,3,5,20.86443742,1591,24.0176410256,1560,22.4255283831,3151
AL,2020,3,6,23.08362457,1465,29.5831707317,1558,26.43337413,3023
AL,2020,3,7,28.03262177,1335,27.3537296898,1354,27.690777264,2689
AL,2020,3,8,25.00273988,1303,32.897311747,1328,28.9875332815,2631
AL,2020,3,9,17.69939214,1464,28.2884159107,1433,22.9372489102,2897
AL,2020,3,10,16.5573758,1570,26.1806333122,1579,21.3827564325,3149
AL,2020,3,11,18.33394681,1766,22.9744403216,1617,20.552001202,3383
AL,2020,3,12,18.83973244,1794,29.9674077977,1898,24.5602979408,3692
AL,2020,3,13,23.54787779,1489,33.3914879518,1660,28.7369514225,3149
AL,2020,3,14,21.15499994,1396,29.4347050659,1441,25.3605181235,2837
AL,2020,3,15,24.41166078,1427,24.9132116788,1370,24.6573256822,2797
AL,2020,3,16,15.39708629,1541,26.354602649,1510,20.8201769823,3051
AL,2020,3,17,13.24601778,1582,24.8698621554,1596,19.0835431491,3178
AL,2020,3,18,11.93530446,1593,23.4759974747,1584,17.6893043767,3177
AL,2020,3,19,14.85746413,1605,25.0194845361,1552,19.8531738767,3157
AL,2020,3,20,12.31334225,1484,22.1011519903,1658,17.4782654039,3142
AL,2020,3,21,11.5272569,1378,21.7662865289,1403,16.692793962,2781
AL,2020,3,22,8.887507407,1348,15.3956301268,1341,12.1330978002,2689
AL,2020,3,23,6.895857327,1458,18.6103133705,1436,12.7085590818,2894
AL,2020,3,24,7.545590929,1506,21.822768254,1575,14.8440506131,3081
AL,2020,3,25,8.349052555,1541,18.9471116816,1558,13.6771506897,3099
AL,2020,3,26,8.80228284,1612,21.4911187932,1591,15.1051045701,3203
AL,2020,3,27,8.988070228,1451,19.8762846104,1553,14.6170305928,3004
AL,2020,3,28,6.411958082,1384,17.8398627168,1384,12.1259103994,2768
AL,2020,3,29,8.494748701,1373,15.9382286521,1417,12.2751827837,2790
AL,2020,3,30,6.6228112,1430,19.1722923816,1457,12.9562348514,2887
AL,2020,3,31,8.850387993,1469,17.0020804911,1466,12.9220681301,2935
AL,2020,4,1,7.490371665,1453,17.8159022801,1535,12.7948192869,2988
AL,2020,4,2,6.352850189,1435,21.1259779614,1452,13.7829096021,2887
AL,2020,4,3,7.047909741,1373,21.0521935056,1509,14.38047886,2882
AL,2020,4,4,7.054707205,1332,17.1443850659,1366,12.1631208292,2698
AL,2020,4,5,4.396198349,1331,13.298732183,1333,8.850807058,2664
AL,2020,4,6,5.697571718,1429,16.0190452617,1414,10.83107984,2843
AL,2020,4,7,7.765259547,1445,14.6484299859,1414,11.1695278228,2859
AL,2020,4,8,5.039682315,1322,16.0872295515,1516,10.9410500424,2838
AL,2020,4,9,6.861153583,1231,18.1055239643,1231,12.4833387736,2462
AL,2020,4,10,7.014262938,1255,18.6655202952,1355,13.0630957805,2610
AL,2020,4,11,8.500324899,1262,21.5635421888,1197,14.8592802044,2459
AL,2020,4,12,5.596264525,1293,13.7913953488,1376,9.82125516329,2669
AL,2020,4,13,5.299870446,1312,13.1471660777,1415,9.37171618084,2727
AL,2020,4,14,5.481891289,1343,16.6891519174,1356,11.1125120419,2699
AL,2020,4,15,4.991851568,1307,19.3752394568,1399,12.4280524757,2706
AL,2020,4,16,6.863088325,1279,18.589409056,1303,12.7807474701,2582
AL,2020,4,17,8.680374353,1202,16.898058104,1308,12.9627370408,2510
AL,2020,4,18,8.206116352,1169,16.6606134454,1190,12.4709961914,2359
AL,2020,4,19,6.181519333,1165,12.5658632479,1170,9.38052677642,2335
AL,2020,4,20,5.390379858,1211,17.467147708,1178,11.3453537078,2389
AL,2020,4,21,5.409968285,1261,15.3981724684,1264,10.4100039633,2525
AL,2020,4,22,5.112806988,1311,17.7085111465,1256,11.2757226183,2567
AL,2020,4,23,5.581998529,1366,16.8533564976,1439,11.3643458077,2805
AL,2020,4,24,6.199966979,1212,18.1634197264,1389,12.588754317,2601
AL,2020,4,25,7.509777749,1080,17.7404459691,1166,12.8209795053,2246
AL,2020,4,26,7.124707466,1094,17.6929406554,1129,12.4920197786,2223
AL,2020,4,27,7.830281862,1171,15.6508638743,1146,11.6983815539,2317
AL,2020,4,28,8.281729494,1168,19.4672020725,1158,13.8504213452,2326
AL,2020,4,29,5.652254814,1193,20.5939823718,1248,13.2914502225,2441
AL,2020,4,30,8.75538651,1229,23.2657881973,1237,16.034124096,2466
AL,2020,5,1,13.3897351,1095,27.5222033898,1357,21.2110073142,2452
AL,2020,5,2,10.16001997,1002,26.9500674374,1038,18.7031911813,2040
AL,2020,5,3,7.408387441,1048,19.4975202156,1113,13.6347663296,2161
AL,2020,5,4,10.97959011,1171,19.6815505804,1206,15.3946361038,2377
AL,2020,5,5,10.9983362,1148,20.0879136691,1251,15.7382534213,2399
AL,2020,5,6,9.108576254,1187,22.8800430663,1161,15.9180621863,2348
AL,2020,5,7,11.99210973,1185,22.3490718321,1239,17.2859529827,2424
AL,2020,5,8,11.67507312,1094,30.0578751014,1233,21.4155092365,2327
AL,2020,5,9,10.89863509,1055,23.0928876509,1077,17.0586773077,2132
AL,2020,5,10,14.33132338,1073,30.1372866128,1113,22.3789158219,2186
AL,2020,5,11,9.958358194,1072,25.7968281938,1135,18.103652009,2207
AL,2020,5,12,8.965021756,1149,24.268415922,1231,16.8803487385,2380
AL,2020,5,13,7.906544248,1062,24.8750656814,1218,16.9713070138,2280
AL,2020,5,14,12.61702328,1075,28.7451945525,1028,20.5008844631,2103
AL,2020,5,15,11.40269654,1094,27.7032481451,1213,19.9733810207,2307
AL,2020,5,16,12.90083565,1065,25.9699815838,1086,19.4992050057,2151
AL,2020,5,17,13.59312678,1065,19.0940221402,1084,16.3678920524,2149
AL,2020,5,18,10.96134488,1093,22.14,1112,16.5988344462,2205
AL,2020,5,19,7.776029137,1166,21.1464972777,1102,14.2726146269,2268
AL,2020,5,20,12.0286919,1162,21.987442845,1181,17.048446431,2343
AL,2020,5,21,14.30852821,1155,24.3952512998,1154,19.349705536,2309
AL,2020,5,22,16.15833945,1090,32.8273044925,1202,24.9000916233,2292
AL,2020,5,23,13.99948216,1004,26.8175023213,1077,20.6333157562,2081
AL,2020,5,24,18.4894117,1037,25.4400481696,1038,21.9664047869,2075
AL,2020,5,25,17.98341301,1087,26.7028952381,1050,22.2676696031,2137
AL,2020,5,26,10.63826477,1118,26.1336147757,1137,18.4512195179,2255
AL,2020,5,27,9.608756551,1142,22.5709482759,1160,16.1405299658,2302
AL,2020,5,28,11.54086293,1182,26.4715866558,1229,19.1517544518,2411
AL,2020,5,29,14.87279446,1095,27.2679491256,1258,21.4996982294,2353
AL,2020,5,30,13.63679165,1119,24.7389576271,1180,19.3351630519,2299
AL,2020,5,31,16.11000864,1165,26.902,1170,21.5175589146,2335
AL,2020,6,1,14.63310849,1290,32.2586950147,1364,23.6916239458,2654
AL,2020,6,2,10.24518871,1272,22.5264193793,1321,16.5018434397,2593
AL,2020,6,3,9.480760577,1249,19.4812547819,1307,14.5944718156,2556
AL,2020,6,4,14.54981447,1186,26.5747906602,1242,20.7009760961,2428
AL,2020,6,5,16.87657446,1083,24.9442294807,1194,21.1070444182,2277
AL,2020,6,6,16.93825597,1055,20.9945943396,1060,18.971219881,2115
AL,2020,6,7,15.88444123,1056,23.768125,1072,19.8559210239,2128
AL,2020,6,8,12.36711056,1104,24.5297096189,1102,18.4428966719,2206
AL,2020,6,9,11.14785013,1121,19.5555319149,1128,15.3647754539,2249
AL,2020,6,10,10.82805902,1118,27.2136092715,1208,19.3378374825,2326
AL,2020,6,11,15.74104677,1070,24.279507772,1158,20.1789003788,2228
AL,2020,6,12,18.22703048,1017,27.6034445446,1109,23.1181138279,2126
AL,2020,6,13,16.80178641,974,29.3150095785,1044,23.2754261464,2018
AL,2020,6,14,19.66624996,1048,26.1517613636,1056,22.9213355314,2104
AL,2020,6,15,14.85321582,1107,26.6851934652,1163,20.9151497413,2270
AL,2020,6,16,12.60042067,1117,22.8066607143,1120,17.7103843936,2237
AL,2020,6,17,12.67540637,1095,23.4827652464,1197,18.319563689,2292
AL,2020,6,18,19.54067418,1157,27.0244444444,1188,23.3320255976,2345
AL,2020,6,19,17.76906221,1109,30.285593361,1205,24.2869619667,2314
AL,2020,6,20,18.15226154,1101,26.6690949423,1127,22.4603725115,2228
AL,2020,6,21,15.6097852,1117,34.098704028,1142,24.9565516018,2259
AL,2020,6,22,15.56331662,1194,28.9502222222,1260,22.4367889341,2454
AL,2020,6,23,12.46863602,1195,23.4257050766,1241,18.0506239917,2436
AL,2020,6,24,12.65193861,1140,22.2424486301,1168,17.5053682909,2308
AL,2020,6,25,12.85111106,1170,29.8513036304,1212,21.5010830983,2382
AL,2020,6,26,18.01923005,1104,25.8147377186,1201,22.0810108352,2305
AL,2020,6,27,16.92369159,1070,29.4772982774,1103,23.2958168437,2173
AL,2020,6,28,22.2326125,1110,23.5409636364,1100,22.8838279977,2210
AL,2020,6,29,10.80006157,1136,26.4916824034,1165,18.74475443,2301
AL,2020,6,30,13.59871374,1104,22.3506858054,1254,18.2530703855,2358
AL,2020,7,1,22.25529615,1131,29.2349710983,1211,25.8643424192,2342
AL,2020,7,2,20.65490122,1163,27.9876969178,1168,24.3291635002,2331
AL,2020,7,3,17.78990965,1108,26.1951546392,1164,22.0961179103,2272
AL,2020,7,4,20.37518516,999,28.4906266549,1133,24.6879408888,2132
AL,2020,7,5,23.93388289,1025,28.2477422389,1063,26.1300670317,2088
AL,2020,7,6,15.50592272,1165,25.8191532977,1122,20.5655837205,2287
AL,2020,7,7,10.39846605,1193,22.2135362802,1199,16.320819397,2392
AL,2020,7,8,14.09406541,1193,21.2502995951,1235,17.734077444,2428
AL,2020,7,9,16.23257331,1158,29.6756880734,1199,23.0710521396,2357
AL,2020,7,10,17.44055948,1108,26.7704170142,1199,22.2894971408,2307
AL,2020,7,11,16.22334266,1068,28.2915384615,1105,22.3601840593,2173
AL,2020,7,12,18.75942253,1091,26.1129422548,1091,22.4361823924,2182
AL,2020,7,13,14.21289456,1185,26.1528036606,1202,20.2253665914,2387
AL,2020,7,14,10.48641926,1226,32.3706978654,1218,21.3927414127,2444
AL,2020,7,15,13.06000001,1196,33.2897280497,1287,23.5455658526,2483
AL,2020,7,16,15.70820102,1134,25.7024605154,1203,20.8528711839,2337
AL,2020,7,17,21.6453652,1068,27.2092579505,1132,24.5082409244,2200
AL,2020,7,18,19.78348615,1047,37.0441001855,1078,28.5396941172,2125
AL,2020,7,19,18.03206047,1058,22.8092271881,1074,20.4385694077,2132
AL,2020,7,20,11.59301735,1150,23.1388666085,1147,17.3584022431,2297
AL,2020,7,21,12.89054361,1159,23.8675826087,1150,18.3576700061,2309
AL,2020,7,22,15.73083837,1169,22.7951240376,1169,19.2629812038,2338
AL,2020,7,23,19.85668674,1162,26.2294762684,1222,23.1232760033,2384
AL,2020,7,24,19.4144044,1083,31.4843423272,1186,25.7233274417,2269
AL,2020,7,25,19.43760043,1071,25.9006493506,1078,22.6796510286,2149
AL,2020,7,26,17.79240122,1037,32.7710116383,1117,25.5598607545,2154
AL,2020,7,27,10.88386072,1106,27.0643208751,1097,18.9410394718,2203
AL,2020,7,28,11.98886562,1146,26.9833536585,1148,19.4926460334,2294
AL,2020,7,29,14.18683627,1160,21.7072489451,1185,17.9871300952,2345
AL,2020,7,30,15.31579307,1160,24.3704605263,1216,19.9498316335,2376
AL,2020,7,31,17.96583178,1034,24.759717564,1133,21.5179649564,2167
AR,2020,1,1,38.39635804,670,39.1299219969,641,38.7550266108,1311
AR,2020,1,2,33.45788528,662,30.1287942122,622,31.8451947472,1284
AR,2020,1,3,29.40965468,608,34.5853514377,626,32.0352512524,1234
AR,2020,1,4,30.4862037,619,39.8742607313,629,35.2178446236,1248
AR,2020,1,5,34.5931639,629,26.6641149068,644,30.5819246607,1273
AR,2020,1,6,30.21895988,673,25.9499509002,611,28.1875233639,1284
AR,2020,1,7,24.63096735,672,25.4274730354,649,25.0222861917,1321
AR,2020,1,8,19.91580977,704,28.8680177515,676,24.3010942595,1380
AR,2020,1,9,20.27998547,680,22.2136595745,705,21.2642744546,1385
AR,2020,1,10,19.65004678,642,32.962553802,697,26.5797087623,1339
AR,2020,1,11,25.47799038,632,29.8128635682,667,27.7038259586,1299
AR,2020,1,12,21.8761086,645,28.0698881789,626,24.9267034201,1271
AR,2020,1,13,22.99455769,667,32.7918759019,693,27.9868676318,1360
AR,2020,1,14,14.8342747,517,21.5650805271,683,18.6652250166,1200
AR,2020,1,15,23.73101623,492,22.5369339623,424,23.178296927,916
AR,2020,1,16,24.68543851,627,24.8574198988,593,24.7690327424,1220
AR,2020,1,17,27.89386686,631,26.1022565688,647,26.9868466265,1278
AR,2020,1,18,31.90184629,612,30.6429283489,642,31.2573284924,1254
AR,2020,1,19,27.79098846,607,29.1647126437,609,28.4789802592,1216
AR,2020,1,20,23.08029963,634,26.3696649916,597,24.6755483066,1231
AR,2020,1,21,21.26194405,679,24.0943010753,651,22.6483082782,1330
AR,2020,1,22,19.55215259,669,23.6125637181,667,21.5793189242,1336
AR,2020,1,23,18.67993667,630,27.7540266223,601,23.1100975647,1231
AR,2020,1,24,35.09985615,626,33.1369384615,650,34.0999372648,1276
AR,2020,1,25,26.7951516,627,33.7131621188,623,30.2430880426,1250
AR,2020,1,26,22.74110603,660,25.2133190883,702,24.0153303816,1362
AR,2020,1,27,16.74966317,594,28.5975773196,582,22.6131717032,1176
AR,2020,1,28,18.81227556,646,24.5871815287,628,21.6589325053,1274
AR,2020,1,29,16.09906401,673,21.9555028736,696,19.0764792394,1369
AR,2020,1,30,15.49280787,666,28.1541935484,651,21.7513971461,1317
AR,2020,1,31,37.74548511,680,30.909137931,696,34.287565316,1376
AR,2020,2,1,28.24907032,710,33.81671875,640,30.8885480942,1350
AR,2020,2,2,23.70761663,428,25.7046133683,763,24.9869688645,1191
AR,2020,2,3,23.91911769,374,18.1213333333,330,21.2014062728,704
AR,2020,2,4,17.81981907,608,25.1551760563,568,21.362746594,1176
AR,2020,2,5,16.11300781,645,28.9236437247,741,22.961984154,1386
AR,2020,2,6,16.11198714,312,21.5979821429,560,19.6351031969,872
AR,2020,2,7,14.03854943,324,11.6580465116,215,13.0889981731,539
AR,2020,2,8,23.11301461,554,22.6531758958,614,22.871284327,1168
AR,2020,2,9,28.21699621,536,21.8249569707,581,24.8922202046,1117
AR,2020,2,10,24.89377446,612,22.4883148148,540,23.7662152513,1152
AR,2020,2,11,21.62960061,601,23.484811784,611,22.5648597084,1212
AR,2020,2,12,25.47631506,597,22.6673370577,537,24.1461376462,1134
AR,2020,2,13,30.55291421,676,25.6948302469,648,28.1752416963,1324
AR,2020,2,14,27.73789142,626,29.4790247453,687,28.648903297,1313
AR,2020,2,15,26.86848739,562,25.1947333333,600,26.0042426103,1162
AR,2020,2,16,34.12902563,585,23.206879562,548,28.8462930217,1133
AR,2020,2,17,23.98341895,623,19.7222240527,607,21.8805365901,1230
AR,2020,2,18,21.42369188,623,23.4728246753,616,22.4424697669,1239
AR,2020,2,19,29.20349679,632,29.3463826367,622,29.274369993,1254
AR,2020,2,20,30.30878116,640,30.6707236842,608,30.4851121333,1248
AR,2020,2,21,32.80709439,616,33.4387654321,567,33.1098479664,1183
AR,2020,2,22,32.38056202,587,33.6498207426,781,33.1051899896,1368
AR,2020,2,23,29.7067558,561,29.6410726644,578,29.6734240595,1139
AR,2020,2,24,20.17082417,631,26.7931164384,584,23.3538848159,1215
AR,2020,2,25,24.05036536,657,24.6014308176,636,24.3214230793,1293
AR,2020,2,26,26.30885486,655,26.0628802589,618,26.18944221,1273
AR,2020,2,27,31.67606879,669,28.957425897,641,30.3458015424,1310
AR,2020,2,28,29.72771613,613,31.3867610063,636,30.5725140014,1249
AR,2020,2,29,29.52978179,596,28.0062376238,606,28.7616721688,1202
AR,2020,3,1,39.71449909,609,31.7688489209,556,35.9224119707,1165
AR,2020,3,2,23.62199387,652,27.8409348915,599,25.6420943271,1251
AR,2020,3,3,22.19740896,660,26.9312135177,651,24.5480624818,1311
AR,2020,3,4,20.68009704,619,30.5247408537,656,25.7452627982,1275
AR,2020,3,5,25.60688085,654,23.4171884984,626,24.5359844343,1280
AR,2020,3,6,31.68964243,643,37.1311737805,656,34.4376367071,1299
AR,2020,3,7,30.6485141,599,26.1152526799,653,28.2841213625,1252
AR,2020,3,8,33.04176777,594,30.0865124555,562,31.6050433005,1156
AR,2020,3,9,26.89272439,635,27.9017123288,584,27.3761115567,1219
AR,2020,3,10,21.67686161,701,26.6755654762,672,24.1234231527,1373
AR,2020,3,11,25.06204393,822,34.0443617021,752,29.3534689393,1574
AR,2020,3,12,23.37387095,806,31.1775404157,866,27.4157236757,1672
AR,2020,3,13,23.36058025,655,32.6081627297,762,28.3335215693,1417
AR,2020,3,14,28.51625984,631,27.598832,625,28.0597372285,1256
AR,2020,3,15,27.7838695,659,25.2394262295,610,26.560772262,1269
AR,2020,3,16,16.59584249,724,21.5703953148,683,19.0106396324,1407
AR,2020,3,17,11.18001381,719,24.2186248331,749,17.8325476358,1468
AR,2020,3,18,14.09600268,738,18.9816949153,708,16.4881673429,1446
AR,2020,3,19,14.43116083,758,20.8037917223,749,17.5984471859,1507
AR,2020,3,20,15.25593272,713,19.6458241758,728,17.4737265991,1441
AR,2020,3,21,13.46642401,632,23.7110752688,651,18.6646063713,1283
AR,2020,3,22,16.88849188,610,15.6219124797,617,16.2515892802,1227
AR,2020,3,23,12.63223751,657,25.4427547771,628,18.8929416685,1285
AR,2020,3,24,10.05707145,700,17.5374235808,687,13.7621917916,1387
AR,2020,3,25,12.91090659,750,15.0107423581,687,13.9147946712,1437
AR,2020,3,26,10.77303342,689,20.5498538012,684,15.6436416798,1373
AR,2020,3,27,8.260425876,681,22.5854985337,682,15.4282171838,1363
AR,2020,3,28,8.373482067,695,14.9002781641,719,11.6922701814,1414
AR,2020,3,29,10.95801831,656,19.3690243902,697,15.2909608362,1353
AR,2020,3,30,9.197250417,651,21.4914880952,672,15.441942571,1323
AR,2020,3,31,12.54750349,697,15.3609800919,653,13.9083925426,1350
AR,2020,4,1,9.878523899,691,16.7215138282,687,13.290087093,1378
AR,2020,4,2,9.953796689,669,14.5207175573,655,12.2131117711,1324
AR,2020,4,3,8.491999948,615,14.6623738872,674,11.7184018371,1289
AR,2020,4,4,6.767512542,599,12.1782107023,598,9.47060151433,1197
AR,2020,4,5,8.236621115,586,19.716892562,605,14.0683291128,1191
AR,2020,4,6,11.22149996,620,13.722515528,644,12.4957515627,1264
AR,2020,4,7,11.29245899,671,14.573734375,640,12.894302046,1311
AR,2020,4,8,10.54043398,622,12.9652838428,687,11.813063358,1309
AR,2020,4,9,12.38399647,568,16.8735925926,540,14.5720667825,1108
AR,2020,4,10,9.689298556,556,14.0053728814,590,11.911361254,1146
AR,2020,4,11,9.776184299,532,15.8330164534,547,12.8467006924,1079
AR,2020,4,12,13.51016284,553,13.9470994941,593,13.7362565886,1146
AR,2020,4,13,10.96606361,597,19.7796396396,555,15.2121874784,1152
AR,2020,4,14,10.22179899,617,20.168372093,602,15.1338884141,1219
AR,2020,4,15,9.753267635,609,22.1836650869,633,16.0885668194,1242
AR,2020,4,16,8.963119505,577,19.9387356322,609,14.5989965889,1186
AR,2020,4,17,8.507281346,526,15.2401243339,563,11.9880807971,1089
AR,2020,4,18,9.005680558,551,21.1466422018,545,15.0429288207,1096
AR,2020,4,19,7.077499998,548,11.7674392523,535,9.39432132863,1083
AR,2020,4,20,13.44117534,570,15.19816609,578,14.325792634,1148
AR,2020,4,21,13.88360923,568,18.7228621908,566,16.2989682916,1134
AR,2020,4,22,9.747929208,594,17.5625680272,588,13.6354145089,1182
AR,2020,4,23,7.773954972,622,23.0573972603,657,15.6247928011,1279
AR,2020,4,24,8.737026525,565,23.2655329949,591,16.1646626182,1156
AR,2020,4,25,10.39448473,524,19.3205688073,545,14.9452011212,1069
AR,2020,4,26,7.720555535,504,16.9887809917,484,12.2608603134,988
AR,2020,4,27,9.181772158,553,21.7380322004,559,15.4937769815,1112
AR,2020,4,28,12.06553776,567,11.9898537477,547,12.0283751436,1114
AR,2020,4,29,7.004313682,561,16.8935344828,580,12.0312620294,1141
AR,2020,4,30,16.05252607,574,20.1768913858,534,18.0402617005,1108
AR,2020,5,1,15.62293536,511,27.2811577181,596,21.8996296016,1107
AR,2020,5,2,12.22677824,478,20.3951717557,524,16.4984730526,1002
AR,2020,5,3,12.78344204,491,16.3640562249,498,14.586420669,989
AR,2020,5,4,15.09571981,514,31.7539212008,533,23.5759694196,1047
AR,2020,5,5,12.22544066,522,21.22382643,507,16.6590476429,1029
AR,2020,5,6,13.40642296,506,25.7653874539,542,19.7981774979,1048
AR,2020,5,7,15.63885816,508,19.3900202429,494,17.4882334783,1002
AR,2020,5,8,19.5903107,483,27.5935055351,542,23.8222439689,1025
AR,2020,5,9,18.3201044,479,20.6237164751,522,19.521388619,1001
AR,2020,5,10,17.63377685,466,26.4284759916,479,22.0916190604,945
AR,2020,5,11,10.91703153,475,19.1413090129,466,14.9898405704,941
AR,2020,5,12,11.41818186,506,23.4147713718,503,17.398642241,1009
AR,2020,5,13,12.52117302,503,17.4903193613,501,15.0007968417,1004
AR,2020,5,14,15.45228104,491,13.0591051454,447,14.3118230177,938
AR,2020,5,15,8.494012158,496,23.2245574388,531,16.1102921425,1027
AR,2020,5,16,12.3042646,476,20.0046443515,478,16.1625261526,954
AR,2020,5,17,14.35584553,479,16.0625690021,471,15.202021062,950
AR,2020,5,18,10.82185554,512,17.5535974304,467,14.0330133161,979
AR,2020,5,19,8.909366868,537,14.7838165138,545,11.8683086951,1082
AR,2020,5,20,11.60559926,534,17.5303269231,520,14.5286148054,1054
AR,2020,5,21,15.45833012,521,27.7988697318,522,21.6345158126,1043
AR,2020,5,22,17.24288748,471,30.1536513761,545,24.1684448849,1016
AR,2020,5,23,14.47305121,449,16.2321681416,452,15.3555382833,901
AR,2020,5,24,19.89209851,467,25.1021413276,467,22.4971199188,934
AR,2020,5,25,18.36386313,497,21.4801147228,523,19.9617058584,1020
AR,2020,5,26,16.33533592,506,24.7233269962,526,20.6106104414,1032
AR,2020,5,27,17.0843395,530,22.2988376384,542,19.7207741931,1072
AR,2020,5,28,25.64431357,561,23.2589254766,577,24.4348505385,1138
AR,2020,5,29,18.75395663,508,28.4768911917,579,23.9329622521,1087
AR,2020,5,30,21.81893994,500,28.2040453686,529,25.101467415,1029
AR,2020,5,31,25.76579425,554,24.7465156794,574,25.2471188072,1128
AR,2020,6,1,20.96910515,581,28.6881094527,603,24.9003210238,1184
AR,2020,6,2,16.34850166,574,22.6888813559,590,19.5622680007,1164
AR,2020,6,3,11.73674954,523,19.9630388693,566,16.0123048755,1089
AR,2020,6,4,17.25539161,549,17.7630485437,515,17.5011090168,1064
AR,2020,6,5,20.28222652,512,17.1597382199,573,18.6332073532,1085
AR,2020,6,6,22.746038,472,18.1301502146,466,20.4528570746,938
AR,2020,6,7,20.85101281,474,24.1567701863,483,22.5194358118,957
AR,2020,6,8,17.17435044,508,22.9176673428,493,20.0029770465,1001
AR,2020,6,9,17.017092,533,24.3089154412,544,20.7002414448,1077
AR,2020,6,10,15.05957366,516,20.75968,500,17.8647441029,1016
AR,2020,6,11,18.59910744,493,20.5009393346,511,19.5670716812,1004
AR,2020,6,12,19.51579182,461,22.7079559118,499,21.1750521136,960
AR,2020,6,13,19.46498884,447,21.5395064378,466,20.5238335285,913
AR,2020,6,14,19.07312242,474,29.5247835052,485,24.3588947102,959
AR,2020,6,15,19.7133008,512,21.151960396,505,20.4276794588,1017
AR,2020,6,16,14.48963186,516,20.4081954887,532,17.4940935494,1048
AR,2020,6,17,16.11058598,529,28.5814092664,518,22.2804870902,1047
AR,2020,6,18,27.60524582,549,24.4032641509,530,26.0324466684,1079
AR,2020,6,19,26.81328008,500,28.2204275093,538,27.5426108285,1038
AR,2020,6,20,29.37654478,492,27.7851960784,510,28.566576878,1002
AR,2020,6,21,28.87860895,496,27.5893306288,493,28.2359252166,989
AR,2020,6,22,14.55135346,532,26.3971752577,485,20.2005408463,1017
AR,2020,6,23,16.91703974,554,27.0682490975,554,21.9926444187,1108
AR,2020,6,24,22.34003621,552,23.7374427481,524,23.0205576096,1076
AR,2020,6,25,20.89458572,519,25.9133815552,553,23.4835727506,1072
AR,2020,6,26,20.13821559,510,25.4470949721,537,22.8611078805,1047
AR,2020,6,27,15.19525586,508,26.4796037736,530,20.9570134652,1038
AR,2020,6,28,22.48747508,503,24.3875445545,505,23.4393948068,1008
AR,2020,6,29,17.11715084,537,23.7619201521,526,20.4051552221,1063
AR,2020,6,30,22.01389857,513,24.5603090909,550,23.3314204764,1063
AR,2020,7,1,24.37688492,565,41.1086751361,551,32.6378315231,1116
AR,2020,7,2,22.7459633,545,33.2483691756,558,28.0590571156,1103
AR,2020,7,3,19.83676177,491,31.6798098859,526,25.9620747582,1017
AR,2020,7,4,20.11743305,448,25.4244950495,505,22.9296747182,953
AR,2020,7,5,25.91154702,446,24.7874159664,476,25.331193027,922
AR,2020,7,6,21.98471795,532,25.703452381,504,23.7938319975,1036
AR,2020,7,7,22.33815599,564,30.2167110266,526,26.1401008976,1090
AR,2020,7,8,20.0333941,548,25.6633580705,539,22.8250689667,1087
AR,2020,7,9,23.33406813,558,26.5280944056,572,24.9508672713,1130
AR,2020,7,10,21.56037627,505,36.5968505338,562,29.4802436892,1067
AR,2020,7,11,15.53043658,504,29.1293592233,515,22.403297386,1019
AR,2020,7,12,25.16943019,509,30.5793155894,526,27.9188019002,1035
AR,2020,7,13,21.21893967,547,25.2315594542,513,23.1608962259,1060
AR,2020,7,14,18.91388315,582,27.7556499133,577,23.3156945585,1159
AR,2020,7,15,18.54815662,575,22.951958042,572,20.7442982184,1147
AR,2020,7,16,23.98678126,553,26.1224954792,553,25.0546383696,1106
AR,2020,7,17,21.58270597,510,25.9143703704,540,23.8104190902,1050
AR,2020,7,18,23.28366054,489,22.3497782258,496,22.8134010194,985
AR,2020,7,19,25.46621982,500,36.4611504425,452,30.6865020063,952
AR,2020,7,20,20.7370899,567,24.0959737828,534,22.3661943445,1101
AR,2020,7,21,16.05571424,560,21.0089734513,565,18.5433510884,1125
AR,2020,7,22,17.41931859,543,18.0522426471,544,17.736071752,1087
AR,2020,7,23,24.17820376,579,28.7936996337,546,26.4182577574,1125
AR,2020,7,24,28.67271667,508,28.9629911504,565,28.8255639034,1073
AR,2020,7,25,18.99957058,489,31.0774226804,485,25.0136961125,974
AR,2020,7,26,20.36059844,518,23.2645454545,495,21.7796051253,1013
AR,2020,7,27,22.16009434,530,21.2251224105,531,21.6921677664,1061
AR,2020,7,28,21.88133695,561,19.7450282486,531,20.842527499,1092
AR,2020,7,29,23.58998201,559,19.5615913201,553,21.5866546255,1112
AR,2020,7,30,26.74471221,556,25.7657249071,538,26.2632723846,1094
AR,2020,7,31,21.54213144,502,34.8067148014,554,28.5010132414,1056
AZ,2020,1,1,28.82699502,3005,42.9904900064,3102,36.0212248297,6107
AZ,2020,1,2,21.78410956,2903,27.0250869894,2644,24.2822426632,5547
AZ,2020,1,3,21.99147755,2917,26.6588969571,2892,24.3151437448,5809
AZ,2020,1,4,19.1944948,2890,25.0462662909,2839,22.0943340848,5729
AZ,2020,1,5,20.24174542,2836,23.3815138593,2814,21.8055168161,5650
AZ,2020,1,6,19.05701393,2870,24.7705787901,2678,21.8149315031,5548
AZ,2020,1,7,14.7145418,2924,25.9313533021,2771,20.1722739637,5695
AZ,2020,1,8,16.48917339,2976,24.648946034,2761,20.4161617585,5737
AZ,2020,1,9,20.61153155,3108,23.4190813202,2939,21.9760740958,6047
AZ,2020,1,10,19.43016098,2858,27.1967262909,2963,23.383490823,5821
AZ,2020,1,11,19.20126211,2797,24.7844927536,2622,21.9027256176,5419
AZ,2020,1,12,23.30495616,2966,23.5455540021,2861,23.4230873469,5827
AZ,2020,1,13,17.87104637,3106,25.4981977725,2963,21.5947652044,6069
AZ,2020,1,14,12.77561692,2464,22.7802436513,2914,18.1964949964,5378
AZ,2020,1,15,16.21213116,2271,19.529672299,1953,17.7460226952,4224
AZ,2020,1,16,19.16591219,3031,25.0167276119,2680,21.9115233493,5711
AZ,2020,1,17,20.47164715,2908,27.8964057295,3002,24.2430727432,5910
AZ,2020,1,18,17.82625,2936,26.5415779883,2744,22.0366126761,5680
AZ,2020,1,19,22.76882431,2926,26.3171742809,2955,24.5517479903,5881
AZ,2020,1,20,19.67353107,2900,28.2467610883,2683,23.7935339608,5583
AZ,2020,1,21,14.37323321,3062,28.350797227,2885,21.1540087589,5947
AZ,2020,1,22,15.31551444,3052,20.0835817308,2912,17.6435848543,5964
AZ,2020,1,23,16.85106186,3023,26.5510178817,2908,21.6070005063,5931
AZ,2020,1,24,17.76754441,2875,26.297693107,2887,22.0415012459,5762
AZ,2020,1,25,16.17443367,3099,22.4638311209,2712,19.109702279,5811
AZ,2020,1,26,19.17332907,3133,23.237566153,3439,21.3000654255,6572
AZ,2020,1,27,16.83946196,2937,25.4649031079,2735,20.9985912864,5672
AZ,2020,1,28,16.43039805,3090,29.3087908145,2787,22.5376093201,5877
AZ,2020,1,29,18.2749403,3099,27.9911038738,2917,22.9860521924,6016
AZ,2020,1,30,24.56425763,3253,25.7381281115,3013,25.1287121083,6266
AZ,2020,1,31,25.16727915,3091,30.2456265823,3160,27.7344808595,6251
AZ,2020,2,1,22.52773667,3190,38.5187166324,2922,30.172639067,6112
AZ,2020,2,2,16.63936308,2057,26.5346027634,3474,22.8545253762,5531
AZ,2020,2,3,25.39405995,1702,22.1491242363,1473,23.8886141842,3175
AZ,2020,2,4,14.57004268,2811,19.565337219,2402,16.8717302846,5213
AZ,2020,2,5,14.0559003,2888,22.9553988693,3184,18.722567534,6072
AZ,2020,2,6,29.14989671,1452,25.7557378939,2602,26.9714060244,4054
AZ,2020,2,7,15.04464414,1630,8.81652753108,1126,12.5000652933,2756
AZ,2020,2,8,19.95694027,2912,25.2496521434,2846,22.5729628458,5758
AZ,2020,2,9,22.50617801,2797,30.3286092715,2869,26.4670949336,5666
AZ,2020,2,10,15.39102885,2877,30.7255762082,2690,22.8007526498,5567
AZ,2020,2,11,14.40899068,2685,27.4244722524,2757,21.0028316751,5442
AZ,2020,2,12,18.34697306,2785,21.5695676134,2359,19.8248308655,5144
AZ,2020,2,13,22.02742635,3190,29.2917697595,2910,25.4928754191,6100
AZ,2020,2,14,20.60431335,3000,30.7249223301,3090,25.739400665,6090
AZ,2020,2,15,18.25522786,2764,25.8411840649,2711,22.0114885489,5475
AZ,2020,2,16,20.61004325,2776,27.9016704545,2640,24.1643076185,5416
AZ,2020,2,17,20.4328365,2905,26.2370782484,2786,23.2742734199,5691
AZ,2020,2,18,18.11097012,3082,28.1333057256,2777,22.8612732394,5859
AZ,2020,2,19,17.11750778,3214,20.4464240506,3160,18.7678647639,6374
AZ,2020,2,20,23.6813179,3126,27.0651381951,3003,25.3392739036,6129
AZ,2020,2,21,24.78746246,2999,33.4627364865,2960,29.0967108437,5959
AZ,2020,2,22,18.40917619,2962,25.6573587951,3718,22.4434191429,6680
AZ,2020,2,23,26.64159277,2888,30.6945769912,2825,28.645737777,5713
AZ,2020,2,24,21.49459104,2971,30.8894856115,2780,26.0360285133,5751
AZ,2020,2,25,17.12084074,3033,28.1941479433,2893,22.5266925353,5926
AZ,2020,2,26,18.86759093,3134,24.8253388373,2907,21.7345290473,6041
AZ,2020,2,27,21.50758965,3095,29.0993076128,2903,25.1819406413,5998
AZ,2020,2,28,24.28460633,3087,28.4428548071,3058,26.3539185908,6145
AZ,2020,2,29,22.31266773,2920,23.8158864028,2905,23.0623415917,5825
AZ,2020,3,1,23.83863461,2871,36.1007332123,2755,29.8432705235,5626
AZ,2020,3,2,18.96921644,2948,38.2724982027,2782,28.3412460847,5730
AZ,2020,3,3,19.76213186,2988,29.9266655208,2909,24.7763133793,5897
AZ,2020,3,4,19.20905935,3168,31.5402971666,2894,25.0959947246,6062
AZ,2020,3,5,25.70270828,3338,26.9622251054,3083,26.3074568196,6421
AZ,2020,3,6,23.77298569,3078,36.0859798679,3179,30.0288604689,6257
AZ,2020,3,7,22.59811779,2853,30.0906937033,2811,26.316626069,5664
AZ,2020,3,8,24.0712704,2692,37.9362793296,2685,30.994749845,5377
AZ,2020,3,9,20.21262313,2863,35.2595989406,2643,27.435499459,5506
AZ,2020,3,10,19.42885881,3251,30.0443286158,2897,24.4309759257,6148
AZ,2020,3,11,21.16860603,3673,26.1830988943,3256,23.5249617475,6929
AZ,2020,3,12,19.02885598,3680,25.4616495987,3613,22.2157041007,7293
AZ,2020,3,13,20.52920467,3244,29.4707107195,3405,25.1082132576,6649
AZ,2020,3,14,20.91665138,3046,25.4150778078,2956,23.132137638,6002
AZ,2020,3,15,20.27788644,3189,28.9893124575,2938,24.4551623726,6127
AZ,2020,3,16,12.52059645,3638,21.5011958146,3345,16.8224874531,6983
AZ,2020,3,17,12.50338849,3745,17.0313556046,3622,14.7295724033,7367
AZ,2020,3,18,9.381468837,3690,17.6424571429,3500,13.4028122404,7190
AZ,2020,3,19,8.706361176,3677,14.8271836735,3430,11.6604094617,7107
AZ,2020,3,20,7.807538727,3486,19.2310247652,3513,13.5413159026,6999
AZ,2020,3,21,8.41157397,3272,16.4166255144,3159,12.3437708023,6431
AZ,2020,3,22,8.684655279,3162,13.2076942839,3114,10.9288782652,6276
AZ,2020,3,23,6.189333749,3302,14.5506813693,3038,10.1959227191,6340
AZ,2020,3,24,5.692851842,3517,18.6476951331,3267,11.9315713338,6784
AZ,2020,3,25,7.400446116,3564,15.4825934718,3370,11.3284583152,6934
AZ,2020,3,26,6.230193897,3610,15.0958821814,3429,10.5490524177,7039
AZ,2020,3,27,7.695077888,3338,16.0115862272,3398,11.8903711387,6736
AZ,2020,3,28,7.532353539,3174,10.2939543974,3070,8.8901553704,6244
AZ,2020,3,29,6.792407799,3281,10.9822536585,3075,8.81943360424,6356
AZ,2020,3,30,6.386448614,3424,15.8755914945,3339,11.0713884451,6763
AZ,2020,3,31,6.985506319,3496,13.023651141,3199,9.87064825858,6695
AZ,2020,4,1,7.18135473,3425,17.2189680446,3411,12.1898829652,6836
AZ,2020,4,2,6.65373158,3323,14.047972973,3108,10.2272508226,6431
AZ,2020,4,3,7.096121431,3228,17.968186864,3243,12.5447550578,6471
AZ,2020,4,4,6.74360256,3120,16.1203871391,3048,11.3772665349,6168
AZ,2020,4,5,6.493239536,2985,20.1599864636,2955,13.2921010126,5940
AZ,2020,4,6,5.645023558,3185,11.5160560492,2926,8.45612502573,6111
AZ,2020,4,7,4.685968734,3329,12.9199900563,3017,8.60056727316,6346
AZ,2020,4,8,6.226441042,3043,11.3176033865,3071,8.78368009336,6114
AZ,2020,4,9,7.109642748,2967,9.11518640351,2736,8.07179730551,5703
AZ,2020,4,10,7.338518949,2937,15.9467126979,2969,11.6659363619,5906
AZ,2020,4,11,6.840790789,2858,11.6537904125,2691,9.17486575508,5549
AZ,2020,4,12,6.570352466,2894,12.379503954,2782,9.41761452371,5676
AZ,2020,4,13,6.26411862,3018,13.1538466998,2818,9.59092700397,5836
AZ,2020,4,14,5.343852055,3123,11.6375143146,2969,8.41113426917,6092
AZ,2020,4,15,6.663110613,3173,11.4513087248,2980,8.98211441168,6153
AZ,2020,4,16,6.027006727,3127,13.9089650492,2947,9.85119691066,6074
AZ,2020,4,17,7.531563347,2872,13.2431068966,2900,10.4011884845,5772
AZ,2020,4,18,6.173796206,2708,11.6108194864,2648,8.86185401902,5356
AZ,2020,4,19,6.177497253,2733,13.4489588101,2622,9.73786554481,5355
AZ,2020,4,20,6.848040368,2827,12.0241965275,2707,9.37999821473,5534
AZ,2020,4,21,8.155189748,2925,11.1613274336,2712,9.60146354673,5637
AZ,2020,4,22,6.939798712,3080,17.1736719577,2835,11.8447912144,5915
AZ,2020,4,23,6.860025349,3152,13.8316856122,3079,10.3050168352,6231
AZ,2020,4,24,6.000453915,2864,14.1667609956,2933,10.1322080408,5797
AZ,2020,4,25,7.67205465,2672,13.0373814898,2658,10.3476716744,5330
AZ,2020,4,26,7.109753737,2639,15.4098444976,2508,11.1541733266,5147
AZ,2020,4,27,6.995427228,2727,12.7265368299,2593,9.78880452082,5320
AZ,2020,4,28,6.694212203,2780,14.6169463493,2479,10.4288495768,5259
AZ,2020,4,29,6.162131081,2914,12.5139465125,2767,9.25585987855,5681
AZ,2020,4,30,8.242569114,2931,12.2139371804,2738,10.1606509214,5669
AZ,2020,5,1,9.722645015,2741,21.0381644935,2991,15.6271667806,5732
AZ,2020,5,2,7.463430964,2457,11.5894228457,2495,9.54225764914,4952
AZ,2020,5,3,8.061513526,2504,16.4074689826,2418,12.1615786,4922
AZ,2020,5,4,5.727196208,2732,12.5897028929,2558,9.04558790931,5290
AZ,2020,5,5,7.325453216,2769,13.6869465082,2692,10.4613513926,5461
AZ,2020,5,6,6.975613764,2729,12.7031293303,2598,9.76894686727,5327
AZ,2020,5,7,8.71197647,2808,12.6813727679,2688,10.6533405982,5496
AZ,2020,5,8,9.641928378,2598,14.0608248547,2752,11.9149756871,5350
AZ,2020,5,9,7.682485931,2490,12.9088990826,2398,10.2465077676,4888
AZ,2020,5,10,9.103594276,2440,17.9549602011,2387,13.4806836614,4827
AZ,2020,5,11,9.553585686,2655,16.2537337253,2381,12.7213880056,5036
AZ,2020,5,12,7.243572228,2665,11.4832937685,2696,9.3756911001,5361
AZ,2020,5,13,6.825312113,2419,14.3249197652,2555,10.6776437478,4974
AZ,2020,5,14,7.663804785,2489,13.7455233348,2207,10.5220570932,4696
AZ,2020,5,15,10.76968335,2589,13.7092838296,2653,12.2574284993,5242
AZ,2020,5,16,9.902053494,2391,18.7639480198,2424,14.3633686198,4815
AZ,2020,5,17,9.588023225,2408,14.4183924843,2395,11.9966708153,4803
AZ,2020,5,18,9.491794583,2619,16.5032540323,2480,12.901957249,5099
AZ,2020,5,19,6.185599218,2645,12.8198681055,2502,9.41057313612,5147
AZ,2020,5,20,7.495724855,2697,15.9078772675,2591,11.6174886411,5288
AZ,2020,5,21,12.09298473,2744,15.0084690067,2678,13.5329823126,5422
AZ,2020,5,22,12.93512991,2464,18.9195605655,2617,16.0174473722,5081
AZ,2020,5,23,10.54798721,2340,21.3252322524,2282,15.8689896303,4622
AZ,2020,5,24,12.29015219,2431,18.5676584138,2383,15.3976090515,4814
AZ,2020,5,25,12.05057499,2522,22.5104247423,2425,17.1779523195,4947
AZ,2020,5,26,9.767684774,2652,19.4703743961,2484,14.4603407361,5136
AZ,2020,5,27,8.639507386,2720,17.4974066874,2572,12.9445937434,5292
AZ,2020,5,28,10.97584922,2838,18.6649469697,2640,14.681438497,5478
AZ,2020,5,29,10.68263997,2750,17.6856725352,2840,14.2405312911,5590
AZ,2020,5,30,8.600205913,2720,16.2052691867,2619,12.3308035369,5339
AZ,2020,5,31,11.8358079,2686,14.1467262724,2908,13.0371219198,5594
AZ,2020,6,1,8.286547507,2769,22.1330147059,2720,15.1479777823,5489
AZ,2020,6,2,7.841388354,2665,14.8667146873,2846,11.4694193365,5511
AZ,2020,6,3,6.294134976,2549,13.506590389,2622,9.95127249155,5171
AZ,2020,6,4,8.555766467,2518,13.3965067946,2502,10.9684223036,5020
AZ,2020,6,5,11.5377583,2342,18.423805095,2473,15.0744548159,4815
AZ,2020,6,6,12.58428952,2231,19.4503228782,2168,15.9681404681,4399
AZ,2020,6,7,11.3605589,2165,14.5992533211,2183,12.9866099399,4348
AZ,2020,6,8,7.733859483,2363,15.7435356812,2158,11.5571024018,4521
AZ,2020,6,9,8.962911403,2425,16.0865258216,2343,12.4634626997,4768
AZ,2020,6,10,9.472290491,2506,18.4063736713,2446,13.8852079908,4952
AZ,2020,6,11,10.27684273,2556,16.0612419872,2496,13.1346931944,5052
AZ,2020,6,12,12.12142984,2357,17.3878396344,2407,14.7822712286,4764
AZ,2020,6,13,12.50951143,2231,19.3489164786,2215,15.9169073325,4446
AZ,2020,6,14,12.32490989,2330,20.7085181899,2254,16.4472164144,4584
AZ,2020,6,15,11.19234657,2510,15.828922629,2404,13.4606267584,4914
AZ,2020,6,16,8.131399595,2565,18.4304276316,2432,13.1438543048,4997
AZ,2020,6,17,9.739695227,2625,17.0968990385,2496,13.3256317069,5121
AZ,2020,6,18,11.55218129,2659,20.2771876194,2617,15.8799564159,5276
AZ,2020,6,19,12.78572459,2491,18.5097440945,2540,15.6756092136,5031
AZ,2020,6,20,13.12895022,2391,19.7911561433,2344,16.4269883793,4735
AZ,2020,6,21,15.26165015,2430,23.1249010526,2375,19.1482726045,4805
AZ,2020,6,22,9.835449163,2516,19.6896149016,2389,14.6349602638,4905
AZ,2020,6,23,8.997512538,2593,20.465925636,2555,14.689391999,5148
AZ,2020,6,24,10.69034536,2577,18.0780843516,2537,14.3553226423,5114
AZ,2020,6,25,9.76500586,2559,19.9346322068,2515,14.8057252652,5074
AZ,2020,6,26,9.675719566,2446,16.574263285,2484,13.1515781052,4930
AZ,2020,6,27,10.49177071,2355,16.5690025685,2336,13.5180793055,4691
AZ,2020,6,28,14.12558955,2451,19.3587951264,2216,16.6104371089,4667
AZ,2020,6,29,11.49051094,2603,13.991124498,2490,12.7130767675,5093
AZ,2020,6,30,8.79024809,2378,19.1384541063,2484,14.0771554829,4862
AZ,2020,7,1,11.9794703,2473,23.414364,2500,17.7279589889,4973
AZ,2020,7,2,12.43422962,2447,17.2358060453,2382,14.802702398,4829
AZ,2020,7,3,10.99943319,2470,21.6676814012,2398,16.2546631017,4868
AZ,2020,7,4,9.26723158,2366,21.7735627868,2397,15.5610959308,4763
AZ,2020,7,5,13.67552579,2282,17.9816457462,2151,15.7649604901,4433
AZ,2020,7,6,14.6545154,2456,21.3060685225,2335,17.8962971869,4791
AZ,2020,7,7,8.985917558,2474,16.7441367666,2369,12.7809250544,4843
AZ,2020,7,8,10.01892799,2556,15.6899752475,2424,12.7792931611,4980
AZ,2020,7,9,9.607830187,2544,20.3317446471,2522,14.9465021705,5066
AZ,2020,7,10,10.88541805,2392,14.3778874949,2471,12.6600205584,4863
AZ,2020,7,11,8.95057513,2295,16.836802926,2324,12.9184455344,4619
AZ,2020,7,12,14.72375422,2352,19.6430267857,2240,17.123399374,4592
AZ,2020,7,13,12.17969591,2433,21.147110734,2357,16.5922630791,4790
AZ,2020,7,14,10.25967355,2481,16.8402846219,2354,13.4635532735,4835
AZ,2020,7,15,6.943288232,2512,16.3630963208,2419,11.5643622062,4931
AZ,2020,7,16,10.75875445,2553,13.4474810765,2378,12.0554066337,4931
AZ,2020,7,17,11.79118954,2295,16.8939300938,2346,14.3705968529,4641
AZ,2020,7,18,14.11169703,2198,22.9642934783,2208,18.5480413236,4406
AZ,2020,7,19,13.53955176,2231,21.2305502063,2181,17.3414709829,4412
AZ,2020,7,20,13.38200511,2349,17.4705636929,2253,15.3836397226,4602
AZ,2020,7,21,8.315479098,2442,17.868700565,2301,12.9500906509,4743
AZ,2020,7,22,9.190022914,2616,16.9119115789,2375,12.8645341501,4991
AZ,2020,7,23,11.0624466,2575,16.3638007812,2560,13.7053807196,5135
AZ,2020,7,24,13.75374032,2334,21.9231738954,2467,17.9516142276,4801
AZ,2020,7,25,13.57047322,2219,18.9069047619,2184,16.2174790087,4403
AZ,2020,7,26,14.32385095,2254,19.4349207829,2146,16.8166591003,4400
AZ,2020,7,27,10.3267757,2354,19.7958723784,2241,14.9448922737,4595
AZ,2020,7,28,9.557679762,2461,15.1629952319,2307,12.2698154141,4768
AZ,2020,7,29,11.49299368,2512,13.3197670549,2404,12.3863141017,4916
AZ,2020,7,30,12.57183711,2553,20.6788006418,2493,16.5771205196,5046
AZ,2020,7,31,11.05676687,2295,26.6680755027,2437,19.0966567977,4732
CA,2020,1,1,18.64220199,22134,38.3255310672,23594,28.7980904226,45728
CA,2020,1,2,15.956261,22022,30.2849559375,20539,22.8709731854,42561
CA,2020,1,3,13.80255672,21551,29.5594817745,22249,21.8065710017,43800
CA,2020,1,4,14.04251241,21334,30.362025274,20891,22.1166614507,42225
CA,2020,1,5,15.69412498,21200,29.1261352094,21463,22.4515315279,42663
CA,2020,1,6,12.62406019,21765,28.7467901058,20982,20.5377645223,42747
CA,2020,1,7,11.70138142,21934,28.4573920537,21469,19.9896285986,43403
CA,2020,1,8,12.26559502,22318,29.6801321565,21187,20.7465006242,43505
CA,2020,1,9,12.90366422,22807,28.716152163,21937,20.6561795965,44744
CA,2020,1,10,14.7466565,20703,33.7691677164,22228,24.5957720416,42931
CA,2020,1,11,13.00371076,20613,28.8358621037,19870,20.774499664,40483
CA,2020,1,12,15.76449673,21531,30.5871197213,21241,23.1255585218,42772
CA,2020,1,13,12.58634715,22807,33.4111790233,21891,22.7853805416,44698
CA,2020,1,14,9.316936279,18778,28.2098898827,22249,19.5626116813,41027
CA,2020,1,15,15.42204344,16800,22.9928694686,15299,19.0304445557,32099
CA,2020,1,16,14.46573898,21211,25.9461772233,18756,19.8533612607,39967
CA,2020,1,17,17.16285333,21904,30.9900203297,22627,24.1886849462,44531
CA,2020,1,18,13.00355319,21724,29.6482256445,20909,21.1667942556,42633
CA,2020,1,19,16.40783016,21693,31.7308068287,22669,24.237877455,44362
CA,2020,1,20,15.84829053,21767,36.1744102907,20951,25.8172154587,42718
CA,2020,1,21,12.66708129,22702,30.9365787778,21732,21.6024172806,44434
CA,2020,1,22,12.67887177,22983,29.5995644661,22570,21.0625135532,45553
CA,2020,1,23,14.42151509,22751,31.4438320819,21975,22.7850042439,44726
CA,2020,1,24,15.33330834,21621,31.6313848872,22074,23.5668302922,43695
CA,2020,1,25,13.94798966,23474,27.5011253787,20793,20.3141394104,44267
CA,2020,1,26,16.90362146,24015,29.6456383953,27295,23.6818976683,51310
CA,2020,1,27,13.68372859,22059,36.8741118895,20842,24.9499920507,42901
CA,2020,1,28,11.71486215,22782,29.5790619981,21791,20.4483729949,44573
CA,2020,1,29,12.37796083,23294,31.4160275991,22392,21.7090555,45686
CA,2020,1,30,14.53424621,23781,29.3985323306,22471,21.7558879426,46252
CA,2020,1,31,15.58837363,22449,33.600860553,23543,24.8088463128,45992
CA,2020,2,1,15.20503159,23263,38.0473875628,22079,26.3279722967,45342
CA,2020,2,2,11.67521079,16270,27.4045037635,25774,21.317651973,42044
CA,2020,2,3,17.49597521,13412,18.5900353238,11890,18.0100995778,25302
CA,2020,2,4,10.02930348,20201,21.3773365826,17440,15.2871259956,37641
CA,2020,2,5,11.27463805,21800,27.4983036145,22825,19.5727930418,44625
CA,2020,2,6,15.46221019,11094,27.153682338,19675,22.9382319818,30769
CA,2020,2,7,9.803908795,11845,16.390695304,8241,12.5063735775,20086
CA,2020,2,8,12.77477476,21601,28.121596253,21137,20.364876447,42738
CA,2020,2,9,15.5576677,20958,28.9999096426,22245,22.4790081628,43203
CA,2020,2,10,13.05368835,21294,29.4197405928,20277,21.0365235314,41571
CA,2020,2,11,11.68111629,20523,26.2978825623,20794,19.037435429,41317
CA,2020,2,12,13.84244609,21246,27.4227182823,18909,20.2373998164,40155
CA,2020,2,13,15.20238988,24043,31.4629036493,22854,23.1265168323,46897
CA,2020,2,14,16.13327601,22051,34.2571957223,23564,25.4958112309,45615
CA,2020,2,15,12.9114239,20282,29.7011845103,20633,21.3783218756,40915
CA,2020,2,16,16.58078888,20243,27.960390754,19987,22.2343832786,40230
CA,2020,2,17,15.75798338,21303,32.5375011035,20389,23.9638163183,41692
CA,2020,2,18,11.9089124,22858,31.437597084,21399,21.3513581951,44257
CA,2020,2,19,11.88416374,23402,29.9455721068,22959,20.8285755235,46361
CA,2020,2,20,14.8082483,23092,34.7508441208,22248,24.5939314015,45340
CA,2020,2,21,15.80846382,21775,35.2145972092,22431,25.6555202841,44206
CA,2020,2,22,12.53310043,21055,29.0869416975,26191,21.7097853692,47246
CA,2020,2,23,17.46875813,20985,30.7968374609,21078,24.1475317823,42063
CA,2020,2,24,14.19463627,22477,35.1512343546,21412,24.4186714083,43889
CA,2020,2,25,12.9071806,22998,32.4620516854,22250,22.5229842079,45248
CA,2020,2,26,12.90692333,23090,31.8983622437,22195,22.214972059,45285
CA,2020,2,27,14.76215094,23408,29.5146137713,22409,21.9775500186,45817
CA,2020,2,28,15.4652544,22246,31.4099533574,22726,23.5226952189,44972
CA,2020,2,29,15.16987768,20686,28.5651377173,21457,21.9900398569,42143
CA,2020,3,1,16.74652611,20637,34.2914505069,20124,25.4085819615,40761
CA,2020,3,2,14.4346843,22697,31.9634424202,21023,22.863483064,43720
CA,2020,3,3,11.77496275,23632,29.4393826299,22936,20.4751674907,46568
CA,2020,3,4,13.57095178,23251,31.6307583984,22653,22.4832208487,45904
CA,2020,3,5,13.69091683,23090,31.6079850208,22164,22.4661388961,45254
CA,2020,3,6,14.45930518,21733,32.5010084145,22580,23.6525816234,44313
CA,2020,3,7,12.45491627,20729,30.5046374579,20770,21.4886932061,41499
CA,2020,3,8,15.23030639,20595,28.421292143,20555,21.8193880948,41150
CA,2020,3,9,12.16216884,22233,30.9046081894,20954,21.2558561562,43187
CA,2020,3,10,9.441447294,24100,25.0278303137,22630,16.9894859787,46730
CA,2020,3,11,10.24565009,26688,26.7337246652,24719,18.1739228043,51407
CA,2020,3,12,10.47950099,27455,26.7698452137,27328,18.6057906592,54783
CA,2020,3,13,10.94867853,25063,27.7584891753,25913,19.4937315599,50976
CA,2020,3,14,9.226440965,23824,23.3962608063,23366,16.2425886745,47190
CA,2020,3,15,9.303488076,24618,22.9657759463,23539,15.9815742147,48157
CA,2020,3,16,8.237060631,26989,19.7471975398,26177,13.9042323923,53166
CA,2020,3,17,7.408580457,27192,19.7995555387,26324,13.5035806074,53516
CA,2020,3,18,6.656147105,27299,18.9698406591,25731,12.6309471963,53030
CA,2020,3,19,5.709158938,28060,18.1189924674,26153,11.6958111486,54213
CA,2020,3,20,5.446516164,27243,19.0366772966,27595,12.2852137178,54838
CA,2020,3,21,5.279786384,25419,17.2431306547,25311,11.248724031,50730
CA,2020,3,22,5.115855769,24113,14.4233523084,23891,9.74808224644,48004
CA,2020,3,23,4.341635587,25153,15.3574562307,23304,9.63937759085,48457
CA,2020,3,24,4.73173677,26227,14.3249887514,24892,9.40309630992,51119
CA,2020,3,25,4.965906167,26386,15.3138034687,24851,9.98484942761,51237
CA,2020,3,26,5.379332838,26680,18.6563325356,25489,11.8662780601,52169
CA,2020,3,27,4.469622471,25270,18.1994481115,25603,11.3794710326,50873
CA,2020,3,28,4.482034531,24379,17.2512766407,23648,10.7694777902,48027
CA,2020,3,29,5.056820794,24201,18.1090240291,23638,11.5061190668,47839
CA,2020,3,30,4.89581849,24814,16.3730147309,23488,10.4768790114,48302
CA,2020,3,31,5.393576697,25845,21.1725272991,24085,13.0049531291,49930
CA,2020,4,1,5.434292191,25600,20.719036423,25094,13.0003822955,50694
CA,2020,4,2,4.610897945,25280,17.2430892759,23601,10.7100437808,48881
CA,2020,4,3,4.705889016,24454,15.2458886989,24564,9.987715125,49018
CA,2020,4,4,4.000668105,23514,13.8457080875,23048,8.87392272284,46562
CA,2020,4,5,4.009121204,22986,15.1008558478,22504,9.49622598363,45490
CA,2020,4,6,4.057892112,23455,15.6699052756,22064,9.68647486735,45519
CA,2020,4,7,4.230768438,24218,18.1633150456,22784,10.9845053409,47002
CA,2020,4,8,4.60159937,22609,14.4186736743,23403,9.59484004513,46012
CA,2020,4,9,5.200056097,22459,15.6324132819,20238,10.1449010442,42697
CA,2020,4,10,4.976121352,22415,17.5967233021,22483,11.295979556,44898
CA,2020,4,11,4.168948291,21622,17.5172584442,20813,10.7158642618,42435
CA,2020,4,12,4.408754752,21594,14.9139530388,21209,9.61410835957,42803
CA,2020,4,13,4.652758032,22400,16.6221104423,20934,10.4349711524,43334
CA,2020,4,14,4.329147364,23363,16.4671036795,21769,10.1837775828,45132
CA,2020,4,15,4.312812379,23521,16.1572628594,22571,10.112974919,46092
CA,2020,4,16,4.788862052,23068,15.7536298884,22042,10.1465524233,45110
CA,2020,4,17,5.309576255,21924,16.1585724644,22066,10.7515846741,43990
CA,2020,4,18,4.600064193,20873,15.5630703185,20848,10.0782826371,41721
CA,2020,4,19,4.990166679,20757,16.3871019704,20300,10.6252054401,41057
CA,2020,4,20,5.284620786,21228,16.3471066881,20499,10.7192290374,41727
CA,2020,4,21,5.061519844,22226,16.6956187971,20152,10.5938800805,42378
CA,2020,4,22,5.528496044,23119,18.4044257212,22254,11.8437262258,45373
CA,2020,4,23,5.160693346,23163,18.0963549697,21923,11.450639444,45086
CA,2020,4,24,5.086178543,21921,18.6872545108,22058,11.9079010401,43979
CA,2020,4,25,4.287525643,20377,16.4318126343,20484,10.3755698595,40861
CA,2020,4,26,5.126531767,19866,17.2193059126,19450,11.1089424174,39316
CA,2020,4,27,5.070398503,20351,18.3181125744,19667,11.581038531,40018
CA,2020,4,28,5.099071738,20598,17.5913400561,19238,11.1319630399,39836
CA,2020,4,29,5.928366498,21200,18.1311851072,19956,11.8453518262,41156
CA,2020,4,30,6.556181991,22242,18.8941510258,20619,12.4915680886,42861
CA,2020,5,1,6.272062385,21160,22.021796477,23162,14.5026327798,44322
CA,2020,5,2,4.902947327,19499,17.5546203158,19187,11.1777663736,38686
CA,2020,5,3,6.118352848,19555,17.7368945975,18880,11.8256006229,38435
CA,2020,5,4,5.55806366,20859,19.3416664949,19406,12.201168009,40265
CA,2020,5,5,5.023817236,21002,16.9823055914,20138,10.8774885656,41140
CA,2020,5,6,5.435251511,20973,16.7362152291,19988,10.9498547384,40961
CA,2020,5,7,5.558694496,21264,17.7528041572,20302,11.5146396036,41566
CA,2020,5,8,5.881629081,20048,18.5033061785,20377,12.2438285669,40425
CA,2020,5,9,6.66199506,19423,18.7247935876,19088,12.6409283075,38511
CA,2020,5,10,7.304234558,18937,21.8722412135,18722,14.5466525884,37659
CA,2020,5,11,5.546790947,19797,20.7393168209,18370,12.8590423763,38167
CA,2020,5,12,4.881270685,20485,16.2641428061,19593,10.4460347318,40078
CA,2020,5,13,5.620976153,18747,18.3795705082,19558,12.1353368996,38305
CA,2020,5,14,5.837002617,19080,15.9749021102,17060,10.6226297712,36140
CA,2020,5,15,6.586442106,20054,19.3160496592,20540,13.0274466668,40594
CA,2020,5,16,6.11932721,19174,19.3658203574,19138,12.7363502277,38312
CA,2020,5,17,6.631374825,18766,20.1823442986,18513,13.360876632,37279
CA,2020,5,18,5.954090885,19541,20.2485293022,18787,12.9607078372,38328
CA,2020,5,19,6.275858859,19922,20.3328812563,18721,13.0859283748,38643
CA,2020,5,20,6.469476615,20157,19.1670124481,19280,12.6770606316,39437
CA,2020,5,21,6.501820124,20180,20.3773747796,19286,13.2824400776,39466
CA,2020,5,22,7.423696114,18790,22.2564969285,19697,15.0148743727,38487
CA,2020,5,23,7.333315917,17811,18.4569845912,17782,12.8906186553,35593
CA,2020,5,24,7.257721914,17967,21.075306925,17545,14.0844151168,35512
CA,2020,5,25,8.222755273,18568,23.3819137921,17771,15.6360964779,36339
CA,2020,5,26,6.740427446,19605,20.761277957,18913,13.62490602,38518
CA,2020,5,27,6.486806601,19960,19.8189738565,19393,13.0568449611,39353
CA,2020,5,28,7.36376824,20702,20.343287845,19712,13.6945518905,40414
CA,2020,5,29,7.361480272,20449,19.7626954358,20902,13.6300154792,41351
CA,2020,5,30,5.882378493,20597,21.385533461,20367,13.5904333029,40964
CA,2020,5,31,7.421315434,20951,17.4911237461,21633,12.5368556185,42584
CA,2020,6,1,6.274651718,21549,24.8995105562,22025,15.6888096083,43574
CA,2020,6,2,5.037022045,21038,17.2495096869,21782,11.2493622088,42820
CA,2020,6,3,4.891117595,19676,15.9298867448,20573,10.5335086536,40249
CA,2020,6,4,6.323261786,18637,17.6023548577,18723,11.9757901474,37360
CA,2020,6,5,7.037112359,17239,21.114008222,18487,14.3214311694,35726
CA,2020,6,6,6.466968102,16277,20.9276155412,16704,13.7909017251,32981
CA,2020,6,7,7.972880429,16001,18.1404872303,16132,13.0774095087,32133
CA,2020,6,8,6.810332354,16819,20.1252777254,15897,13.2801846149,32716
CA,2020,6,9,6.662503215,17853,17.7938998536,17075,12.1042289824,34928
CA,2020,6,10,7.300013191,18193,21.051178811,17594,14.060513035,35787
CA,2020,6,11,6.697478247,18150,20.1481767282,18039,13.4021992921,36189
CA,2020,6,12,7.911506296,16889,23.0788959333,17508,15.631675432,34397
CA,2020,6,13,7.673028448,16411,21.1718529013,16234,14.3858456076,32645
CA,2020,6,14,8.980498044,16705,24.2615193752,16645,16.6072626634,33350
CA,2020,6,15,7.979408759,17523,22.3355638435,17026,15.0542270307,34549
CA,2020,6,16,7.183363883,17884,22.3310116388,17012,14.5679289799,34896
CA,2020,6,17,6.966295467,18364,20.8582572211,17518,13.7485090005,35882
CA,2020,6,18,8.84821762,18610,22.7454114335,18472,15.7709554476,37082
CA,2020,6,19,8.755353276,17436,22.9535280076,18013,15.9699918113,35449
CA,2020,6,20,8.613811654,16990,23.928083544,16614,16.1852708011,33604
CA,2020,6,21,10.27442203,16766,28.422463907,16693,19.3286454991,33459
CA,2020,6,22,8.86172003,17523,22.3280108715,16741,15.4411963018,34264
CA,2020,6,23,7.311078058,17819,23.9567034216,17594,15.5810109258,35413
CA,2020,6,24,7.690878736,17821,23.9820976995,17257,15.7055194126,35078
CA,2020,6,25,8.519309079,17904,21.3085937232,17493,14.8397022276,35397
CA,2020,6,26,9.077248347,17306,23.1173974014,17471,16.1306297235,34777
CA,2020,6,27,8.169017349,16842,23.6838858063,16761,15.9077522897,33603
CA,2020,6,28,9.9422861,17042,24.3318341164,16602,17.0429660479,33644
CA,2020,6,29,8.25051435,17964,25.2433504583,17129,16.544769321,35093
CA,2020,6,30,7.522033477,17207,21.3229552104,17772,14.5339543737,34979
CA,2020,7,1,9.538467229,17987,27.2849328915,18105,18.4407104081,36092
CA,2020,7,2,10.7247461,17962,25.0935355992,17683,17.8529072646,35645
CA,2020,7,3,9.837566691,17881,25.8667783447,17640,17.7977956702,35521
CA,2020,7,4,8.451380667,17122,24.0519716763,17300,16.2920123694,34422
CA,2020,7,5,10.61480458,16659,24.4283624177,16561,17.5012082931,33220
CA,2020,7,6,8.772925479,17532,25.6741810573,16967,17.0851549175,34499
CA,2020,7,7,8.473882992,18017,25.9765757114,17078,16.9910787824,35095
CA,2020,7,8,8.458075027,18338,23.791358714,17730,15.9954799225,36068
CA,2020,7,9,8.97773316,18453,24.6800191993,17709,16.6673461092,36162
CA,2020,7,10,9.69256381,17669,24.988859484,18062,17.4248324972,35731
CA,2020,7,11,8.185157148,17213,23.8279997627,16858,15.9250837953,34071
CA,2020,7,12,9.741914328,17275,23.7640020221,16814,16.6581448566,34089
CA,2020,7,13,8.828066048,18258,26.442947238,17759,17.5134833524,36017
CA,2020,7,14,8.032104015,18208,23.3952836158,17700,15.6050203271,35908
CA,2020,7,15,8.181352442,18204,21.8096808149,17670,14.8940848485,35874
CA,2020,7,16,8.727729667,18178,23.248316679,17513,15.8527483087,35691
CA,2020,7,17,9.639553849,17304,27.0223465786,17566,18.396254081,34870
CA,2020,7,18,8.667655825,16364,24.6985714286,16394,16.6904542378,32758
CA,2020,7,19,10.6230385,16574,26.3153651911,16197,18.378939004,32771
CA,2020,7,20,8.672482572,17639,25.5199267702,16933,16.924182578,34572
CA,2020,7,21,8.276731814,18059,22.6990599391,17084,15.2878308576,35143
CA,2020,7,22,8.376110082,18805,23.2020864365,17724,15.5697262474,36529
CA,2020,7,23,8.811094994,19059,24.1416239133,18634,16.3899312735,37693
CA,2020,7,24,9.722325798,17525,26.8597328662,18268,18.4689006121,35793
CA,2020,7,25,8.829034042,16388,22.8720119703,16541,15.8831473741,32929
CA,2020,7,26,10.93294886,16274,26.7406134201,15976,18.763747279,32250
CA,2020,7,27,9.361742362,17568,27.1250705663,16651,18.0053958273,34219
CA,2020,7,28,8.178979112,18053,21.850937266,17359,14.8809875158,35412
CA,2020,7,29,8.555953817,18798,22.6397365256,17459,15.3377824931,36257
CA,2020,7,30,9.196897979,18849,22.0037417132,19157,15.6522130718,38006
CA,2020,7,31,10.5149359,16384,26.171954146,17752,18.6571724802,34136
CO,2020,1,1,32.5123917,1756,40.1896510417,1920,36.5222768839,3676
CO,2020,1,2,32.40015519,1738,26.7863542926,1654,29.6627652477,3392
CO,2020,1,3,34.85364472,1734,33.0544158076,1746,33.950928145,3480
CO,2020,1,4,31.5428159,1765,29.88,1771,30.7099971899,3536
CO,2020,1,5,30.08989285,1682,31.7332815199,1737,30.9248054325,3419
CO,2020,1,6,23.73161277,1761,30.0711071215,1671,26.8182372051,3432
CO,2020,1,7,24.9850632,1821,26.3975840093,1726,25.672407693,3547
CO,2020,1,8,28.38860166,1845,25.3172518646,1743,26.8965830721,3588
CO,2020,1,9,29.18822444,1915,38.9296549865,1855,33.9814216983,3770
CO,2020,1,10,30.08946402,1791,34.6626418152,1851,32.4137232454,3642
CO,2020,1,11,26.22205572,1756,25.6734423408,1743,25.948768175,3499
CO,2020,1,12,30.36444381,1780,28.9620228385,1839,29.6518015976,3619
CO,2020,1,13,24.39310961,1862,29.7380960086,1854,27.0598493256,3716
CO,2020,1,14,16.10988124,1431,28.4197526113,1819,22.9996215552,3250
CO,2020,1,15,21.44566616,1366,18.8720475786,1177,20.2544946813,2543
CO,2020,1,16,22.71340816,1781,26.7198554217,1660,24.6461900415,3441
CO,2020,1,17,25.3151165,1761,26.8016065574,1830,26.0726427615,3591
CO,2020,1,18,21.05428905,1751,30.6625888325,1773,25.8884307964,3524
CO,2020,1,19,26.13093364,1746,26.9076885513,1843,26.5298077836,3589
CO,2020,1,20,29.24897744,1770,26.5807760141,1701,27.9413973117,3471
CO,2020,1,21,22.2116848,1840,25.1621352113,1775,23.6603845178,3615
CO,2020,1,22,23.0545075,1837,24.0111331445,1765,23.5232593774,3602
CO,2020,1,23,29.17465609,1817,30.0147619048,1743,29.5859775605,3560
CO,2020,1,24,25.3947166,1747,24.5818552556,1741,24.9889850631,3488
CO,2020,1,25,24.26594294,1787,27.9970667483,1633,26.0475000099,3420
CO,2020,1,26,31.77685756,1782,27.7812028911,1937,29.6957650368,3719
CO,2020,1,27,23.56850776,1749,27.64642376,1633,25.5375310681,3382
CO,2020,1,28,25.80837746,1812,27.5297043478,1725,26.6478710652,3537
CO,2020,1,29,22.99417329,1881,29.9707255008,1847,26.4506357185,3728
CO,2020,1,30,25.31236616,1961,29.2910257817,1823,27.2291464164,3784
CO,2020,1,31,29.28338448,1956,33.6399843342,1915,31.4386127726,3871
CO,2020,2,1,31.75168595,2064,36.4246549949,1942,34.0170144286,4006
CO,2020,2,2,22.45476744,1311,26.690524849,2153,25.0874422961,3464
CO,2020,2,3,25.91875954,1048,14.3089783282,969,20.3412295478,2017
CO,2020,2,4,18.65038208,1701,13.6737966102,1475,16.3391529969,3176
CO,2020,2,5,20.27878377,1850,24.9077905237,2005,22.6863475939,3855
CO,2020,2,6,23.4890436,920,22.0258739076,1602,22.5596233592,2522
CO,2020,2,7,15.43204908,1020,8.74244725738,711,12.6843270142,1731
CO,2020,2,8,20.9988509,1810,21.6968449487,1851,21.351756386,3661
CO,2020,2,9,28.00132938,1670,26.2639685315,1716,27.1208476269,3386
CO,2020,2,10,20.26479574,1714,21.662798722,1565,20.9320341258,3279
CO,2020,2,11,22.6157614,1668,27.0403809524,1680,24.8360006019,3348
CO,2020,2,12,25.92600217,1831,26.8902920635,1575,26.3719083891,3406
CO,2020,2,13,25.37736648,2058,32.587570829,1906,28.8442306296,3964
CO,2020,2,14,32.21773702,1878,26.610805169,2012,29.3176992606,3890
CO,2020,2,15,23.80702596,1735,26.4450690226,1811,25.1543175523,3546
CO,2020,2,16,29.44943925,1694,38.5073079112,1757,34.061051895,3451
CO,2020,2,17,28.03748184,1787,30.5706898585,1696,29.2709934103,3483
CO,2020,2,18,25.6652507,1935,30.2119908728,1753,27.8264316986,3688
CO,2020,2,19,20.37274443,1964,26.5732173448,1868,23.3953131682,3832
CO,2020,2,20,28.74586889,1922,26.9741896362,1814,27.8856370467,3736
CO,2020,2,21,28.8598564,1811,26.7274931129,1815,27.7924986046,3626
CO,2020,2,22,26.23433525,1730,24.054950495,2222,25.0089827891,3952
CO,2020,2,23,35.62289224,1708,27.2714318182,1760,31.3845501574,3468
CO,2020,2,24,22.16371926,1788,28.889729892,1666,25.4079386326,3454
CO,2020,2,25,21.76577423,1834,23.2936856981,1769,22.515947804,3603
CO,2020,2,26,26.43359344,1820,26.7228930066,1673,26.5721557575,3493
CO,2020,2,27,25.47779191,1875,30.0659501188,1684,27.6487552209,3559
CO,2020,2,28,27.74063848,1754,32.4399440716,1788,30.1128458199,3542
CO,2020,2,29,28.5389875,1679,24.8243267504,1671,26.686092541,3350
CO,2020,3,1,31.01983182,1666,32.7733292308,1625,31.8856577977,3291
CO,2020,3,2,28.36239222,1831,27.6493536585,1640,28.0254912575,3471
CO,2020,3,3,23.43811318,1908,27.7442429285,1803,25.5302586762,3711
CO,2020,3,4,23.82538377,1915,32.7978472607,1807,28.1814400644,3722
CO,2020,3,5,27.98787881,1867,25.1514602998,1801,26.5951880421,3668
CO,2020,3,6,24.86624078,1753,31.6839636752,1872,28.3870069206,3625
CO,2020,3,7,20.90032054,1716,28.242967853,1742,24.5992481338,3458
CO,2020,3,8,28.234919,1667,28.1637093916,1693,28.1990386824,3360
CO,2020,3,9,26.11804893,1758,32.5304107143,1680,29.2514892434,3438
CO,2020,3,10,19.50521962,1981,26.0621606648,1805,22.6312836945,3786
CO,2020,3,11,23.78711539,2236,23.119168207,2164,23.4586068209,4400
CO,2020,3,12,23.3487466,2282,34.2074289406,2322,28.8252584147,4604
CO,2020,3,13,21.15774665,2037,22.8082580645,2170,22.009091972,4207
CO,2020,3,14,20.41593945,1948,32.4166457352,1911,26.3587613497,3859
CO,2020,3,15,17.09839668,2027,28.793099324,1923,22.7917924229,3950
CO,2020,3,16,14.4275642,2221,19.9423159434,2051,17.0752130356,4272
CO,2020,3,17,13.37280225,2266,21.6226629681,2163,17.401803996,4429
CO,2020,3,18,14.19164121,2224,18.0454859086,2058,16.0438626929,4282
CO,2020,3,19,9.454433117,2258,16.072704956,2159,12.6894000403,4417
CO,2020,3,20,11.87840187,2115,15.5289651972,2155,13.7207821909,4270
CO,2020,3,21,9.805347523,2014,16.6173049645,1974,13.1771639697,3988
CO,2020,3,22,9.178819167,1880,15.9325692558,1841,12.5203010035,3721
CO,2020,3,23,7.585957545,2026,13.9574625268,1868,10.6424473514,3894
CO,2020,3,24,6.997067945,2135,16.2761758893,2024,11.5127963603,4159
CO,2020,3,25,7.553899093,2239,11.9986260281,2067,9.68749188788,4306
CO,2020,3,26,8.514036323,2257,13.610106927,2151,11.0007985438,4408
CO,2020,3,27,7.678485624,2047,16.6251557936,2054,12.1594562478,4101
CO,2020,3,28,8.848168637,1933,12.7666666667,1866,10.7728639051,3799
CO,2020,3,29,8.532881679,1919,18.7857034632,1848,13.5626705447,3767
CO,2020,3,30,7.024888131,1966,15.0968783931,1842,10.9294590508,3808
CO,2020,3,31,7.806732374,2081,16.5738560687,1862,11.9468247706,3943
CO,2020,4,1,8.102415862,2169,15.6354150763,2096,11.8044478323,4265
CO,2020,4,2,5.979575032,2118,11.1371176174,1981,8.47215660351,4099
CO,2020,4,3,7.277995872,1916,17.7440456123,2017,12.6454055659,3933
CO,2020,4,4,6.345184607,1869,12.0786041439,1834,9.18479882001,3703
CO,2020,4,5,7.996804375,1840,15.5309659408,1791,11.7130487607,3631
CO,2020,4,6,6.746036733,1905,7.79870752089,1795,7.25672431794,3700
CO,2020,4,7,7.709055809,1970,14.9668820075,1873,11.2463726109,3843
CO,2020,4,8,4.807289901,1797,14.9285451761,1959,10.0861874207,3756
CO,2020,4,9,9.789239678,1723,12.6746453233,1593,11.1753829811,3316
CO,2020,4,10,8.887220579,1691,17.7060656682,1736,13.3545433321,3427
CO,2020,4,11,5.754876143,1655,11.5099022005,1636,8.61577636483,3291
CO,2020,4,12,7.44852182,1698,13.0341066021,1651,10.2021200509,3349
CO,2020,4,13,8.944522505,1822,15.1277546158,1679,11.9098600412,3501
CO,2020,4,14,9.040878312,1890,16.6754917567,1759,12.7211427815,3649
CO,2020,4,15,7.993890376,1915,12.7654596729,1773,10.2878145526,3688
CO,2020,4,16,7.66288801,1991,10.9524429102,1883,9.26181208774,3874
CO,2020,4,17,8.463196948,1833,18.5483278328,1818,13.4850451947,3651
CO,2020,4,18,8.280962983,1703,17.1838439636,1756,12.8006099913,3459
CO,2020,4,19,5.570995802,1677,12.9965657813,1619,9.21844658979,3296
CO,2020,4,20,9.768414423,1747,23.7321853147,1716,16.6877995949,3463
CO,2020,4,21,7.724298055,1738,16.4304205318,1617,11.9203636422,3355
CO,2020,4,22,10.72728716,1891,18.0199705709,1699,14.1786156043,3590
CO,2020,4,23,8.397048452,1938,14.681626898,1844,11.4612374141,3782
CO,2020,4,24,8.574223804,1707,13.7880087527,1828,11.2703479585,3535
CO,2020,4,25,7.657666216,1534,11.8299018967,1529,9.74037870563,3063
CO,2020,4,26,8.493610934,1465,14.0238969072,1455,11.2492842528,2920
CO,2020,4,27,8.021356631,1570,18.6325987944,1493,13.1936010156,3063
CO,2020,4,28,7.732356566,1621,15.0416666667,1524,11.2742925258,3145
CO,2020,4,29,6.738465687,1662,13.7760949868,1516,10.0956230245,3178
CO,2020,4,30,10.64721314,1726,13.8301106331,1627,12.1916730926,3353
CO,2020,5,1,11.64075089,1638,20.7213857466,1768,16.3543628766,3406
CO,2020,5,2,10.96393301,1523,14.3463918206,1516,12.6512668556,3039
CO,2020,5,3,8.193741507,1478,14.7069803371,1424,11.3897622148,2902
CO,2020,5,4,10.84519033,1655,15.5845252525,1485,13.086563693,3140
CO,2020,5,5,8.343938057,1615,14.0100653595,1530,11.1004324204,3145
CO,2020,5,6,7.0824491,1621,16.4018720853,1501,11.5630557307,3122
CO,2020,5,7,10.8178034,1648,15.6747820513,1560,13.1796758115,3208
CO,2020,5,8,11.64797163,1479,16.9382614295,1553,14.3576748156,3032
CO,2020,5,9,9.726737473,1459,14.7667195386,1387,12.1829760974,2846
CO,2020,5,10,13.00302202,1456,16.5809041468,1471,14.8011308716,2927
CO,2020,5,11,11.82193734,1533,18.0691608392,1430,14.8369658934,2963
CO,2020,5,12,8.631078004,1577,14.3156366048,1508,11.4097860656,3085
CO,2020,5,13,10.00857145,1512,17.9110126582,1580,14.0466882382,3092
CO,2020,5,14,11.08017336,1557,14.0312939417,1337,12.4435625161,2894
CO,2020,5,15,12.09981661,1581,12.9371304348,1610,12.5222783016,3191
CO,2020,5,16,11.41042775,1473,15.8068187919,1490,13.6212352601,2963
CO,2020,5,17,12.24959172,1445,12.9618168813,1398,12.5998171071,2843
CO,2020,5,18,11.36323603,1576,19.1244652778,1440,15.0688627266,3016
CO,2020,5,19,10.61124391,1632,17.5135612903,1550,13.9734663926,3182
CO,2020,5,20,10.85185203,1609,14.5500769724,1559,12.6717802766,3168
CO,2020,5,21,11.44379481,1589,17.7992857143,1540,14.5717769105,3129
CO,2020,5,22,13.51798808,1511,18.2531763967,1593,15.9481282181,3104
CO,2020,5,23,8.865951982,1418,15.9015838068,1408,12.3713198551,2826
CO,2020,5,24,12.61527734,1406,20.6711557093,1445,16.6983163592,2851
CO,2020,5,25,14.52225674,1480,18.2482219061,1406,16.3374705389,2886
CO,2020,5,26,10.64866753,1561,19.8239878951,1487,15.1249475113,3048
CO,2020,5,27,10.24809982,1663,15.0346848603,1539,12.5487101813,3202
CO,2020,5,28,14.0412479,1763,17.2204649794,1699,15.6014702622,3462
CO,2020,5,29,13.8894087,1759,22.1566353591,1810,18.0820901943,3569
CO,2020,5,30,13.15796986,1660,17.5176999448,1813,15.4338669645,3473
CO,2020,5,31,15.8609832,1668,16.9698188406,1656,16.4133995119,3324
CO,2020,6,1,14.9026809,1742,19.8686062718,1722,17.3713077736,3464
CO,2020,6,2,10.36088854,1677,12.3090210586,1757,11.3576470826,3434
CO,2020,6,3,9.581635809,1620,13.6669625,1600,11.6116118045,3220
CO,2020,6,4,11.666632,1636,13.9840906269,1611,12.8164397758,3247
CO,2020,6,5,13.84343668,1516,17.0584984227,1585,15.4867365388,3101
CO,2020,6,6,14.43956464,1378,20.0521581769,1492,17.3573310362,2870
CO,2020,6,7,15.02689303,1281,22.6081316348,1413,19.0032442359,2694
CO,2020,6,8,10.81217487,1338,23.6928338509,1288,17.1298781325,2626
CO,2020,6,9,12.71220461,1515,18.3077260083,1438,15.4370132015,2953
CO,2020,6,10,14.51247401,1536,20.0959750173,1441,17.2151360697,2977
CO,2020,6,11,13.99709138,1499,24.6868399453,1462,19.2751772977,2961
CO,2020,6,12,18.21783326,1403,23.3493503801,1447,20.8232035312,2850
CO,2020,6,13,18.20081138,1368,18.9144850746,1340,18.5539586292,2708
CO,2020,6,14,15.5076918,1382,25.1671364653,1341,20.2646933777,2723
CO,2020,6,15,13.76143422,1492,17.8531834153,1423,15.7588815973,2915
CO,2020,6,16,12.08474094,1525,20.9316965517,1450,16.3967024987,2975
CO,2020,6,17,14.44750823,1525,16.7775382476,1438,15.5783159132,2963
CO,2020,6,18,14.5918194,1550,20.2797662338,1540,17.4265890194,3090
CO,2020,6,19,17.21796558,1396,22.1654110512,1484,19.7672742881,2880
CO,2020,6,20,15.92995737,1406,20.8242921348,1335,18.3137358855,2741
CO,2020,6,21,21.2229645,1464,24.6646081277,1378,22.8917135918,2842
CO,2020,6,22,17.3281536,1484,19.0234423898,1406,18.1529203953,2890
CO,2020,6,23,13.9957181,1504,27.9250905433,1491,20.9301736302,2995
CO,2020,6,24,15.6683378,1498,21.1042046251,1427,18.3202974442,2925
CO,2020,6,25,13.46086546,1583,20.6764564369,1538,17.0166421093,3121
CO,2020,6,26,16.39427065,1515,21.3723452158,1599,18.9504495937,3114
CO,2020,6,27,18.12284344,1456,19.4117002082,1441,18.7639351221,2897
CO,2020,6,28,23.19782694,1422,29.0310974778,1467,26.1598926648,2889
CO,2020,6,29,17.39942075,1571,24.9325697211,1506,21.0864283387,3077
CO,2020,6,30,14.30308133,1428,22.0961706222,1559,18.3705156141,2987
CO,2020,7,1,18.09627142,1518,29.2878705502,1545,23.741397328,3063
CO,2020,7,2,19.05862858,1524,26.5191965471,1506,22.7667524607,3030
CO,2020,7,3,21.43756327,1502,21.0332315003,1473,21.2373680778,2975
CO,2020,7,4,17.17994269,1396,24.4025309491,1454,20.8647298229,2850
CO,2020,7,5,22.11913224,1429,25.8174981046,1319,23.8942940215,2748
CO,2020,7,6,19.792793,1493,30.4126286509,1438,25.003070607,2931
CO,2020,7,7,16.40387102,1550,25.9932633717,1477,21.082936928,3027
CO,2020,7,8,18.72986671,1576,26.9069354839,1550,22.7843953727,3126
CO,2020,7,9,16.37784658,1630,22.6123212045,1594,19.4602760315,3224
CO,2020,7,10,18.78502002,1494,26.2754446577,1563,22.6147660811,3057
CO,2020,7,11,19.30221016,1475,32.8673907009,1441,26.0057167305,2916
CO,2020,7,12,21.13291257,1466,26.6117715458,1462,23.8685996679,2928
CO,2020,7,13,17.84141836,1544,25.2708408797,1546,21.5585339637,3090
CO,2020,7,14,15.31747882,1650,21.8992737789,1556,18.5118871032,3206
CO,2020,7,15,18.51254938,1620,21.3639539228,1606,19.9320644748,3226
CO,2020,7,16,15.65503681,1632,26.7640554822,1514,21.0012079065,3146
CO,2020,7,17,20.05507405,1553,28.9892745466,1599,24.5873667512,3152
CO,2020,7,18,22.32811356,1426,27.8310259918,1462,25.1138677066,2888
CO,2020,7,19,21.30536391,1415,23.7176694329,1446,22.5245857856,2861
CO,2020,7,20,17.68329681,1550,30.9168639053,1521,24.2375968921,3071
CO,2020,7,21,18.52112697,1606,38.2959685864,1528,28.162466469,3134
CO,2020,7,22,16.57159407,1675,26.5210329531,1578,21.3979741984,3253
CO,2020,7,23,22.08019649,1731,27.0321043165,1668,24.5102589362,3399
CO,2020,7,24,21.71019545,1586,24.3310822249,1654,23.0481419703,3240
CO,2020,7,25,21.1694482,1486,22.2928309572,1473,21.7286718571,2959
CO,2020,7,26,25.82470354,1467,24.6568149718,1416,25.2510891756,2883
CO,2020,7,27,16.20752112,1541,28.5594256055,1445,22.1849162913,2986
CO,2020,7,28,12.84272392,1608,26.4882436811,1543,19.5247413721,3151
CO,2020,7,29,16.63467175,1691,24.114506957,1653,20.3320902898,3344
CO,2020,7,30,18.9010725,1641,22.9549284381,1607,20.906782627,3248
CO,2020,7,31,24.7452719,1434,25.8830361757,1548,25.3359020471,2982
CT,2020,1,1,16.64566703,1087,17.3509964093,1114,17.0026579108,2201
CT,2020,1,2,13.47605086,1061,23.8115289256,968,18.4069245749,2029
CT,2020,1,3,13.29440769,1089,20.1562417375,1059,16.6774068782,2148
CT,2020,1,4,14.50747014,1091,13.7856010686,1123,14.141318845,2214
CT,2020,1,5,17.29860193,987,15.9670841683,998,16.6291537052,1985
CT,2020,1,6,9.354627375,1087,18.6587079832,952,13.6986610871,2039
CT,2020,1,7,10.64177193,1140,11.693865932,1089,11.1557828624,2229
CT,2020,1,8,14.05968609,1115,16.0219497487,995,14.9850189528,2110
CT,2020,1,9,14.63007287,1099,10.1820769231,1040,12.4674193942,2139
CT,2020,1,10,21.58006514,1075,20.8578537512,1053,21.2226926812,2128
CT,2020,1,11,14.46803119,1087,17.9192315271,1015,16.1345242167,2102
CT,2020,1,12,14.70146023,1082,20.7097669903,1030,17.6316477125,2112
CT,2020,1,13,9.713272725,1100,18.2206356736,1054,13.876114205,2154
CT,2020,1,14,11.22822282,934,14.7497697974,1086,13.1214901554,2020
CT,2020,1,15,14.36843749,896,20.2875197889,758,17.0810519897,1654
CT,2020,1,16,11.75539574,1099,12.4085784314,1020,12.0698111931,2119
CT,2020,1,17,17.37459503,1099,17.4729582929,1031,17.4222065436,2130
CT,2020,1,18,11.49157657,1091,13.1786288848,1094,12.3362608869,2185
CT,2020,1,19,13.63850946,1060,17.898585086,1046,15.7543874775,2106
CT,2020,1,20,14.62278776,1112,13.9377512438,1005,14.2975814781,2117
CT,2020,1,21,13.31548961,1113,12.7028922495,1058,13.0169506844,2171
CT,2020,1,22,13.33962822,1103,10.9769516729,1076,12.1729279149,2179
CT,2020,1,23,16.59531565,1140,23.4596603774,1060,19.9026817459,2200
CT,2020,1,24,15.33303359,1101,13.9711217641,1043,14.670499059,2144
CT,2020,1,25,12.14182448,1151,13.610108055,1018,12.8309497356,2169
CT,2020,1,26,15.06502201,1133,17.0283415033,1224,16.0845820693,2357
CT,2020,1,27,14.00939189,1036,13.7546897253,983,13.8853838524,2019
CT,2020,1,28,16.69014041,1069,14.1914172448,1009,15.4768527903,2078
CT,2020,1,29,10.47777175,1104,12.1807572816,1030,11.2997375876,2134
CT,2020,1,30,12.52334782,1150,17.081197318,1044,14.6921695501,2194
CT,2020,1,31,21.83523639,1142,13.3560915493,1136,17.6068305344,2278
CT,2020,2,1,16.00071897,1210,25.438373436,1039,20.3607558709,2249
CT,2020,2,2,14.44745699,814,18.3061198738,1268,16.7974975936,2082
CT,2020,2,3,15.72417661,668,8.84449494949,594,12.4860380154,1262
CT,2020,2,4,9.772107647,1077,13.1371350165,911,11.3141297464,1988
CT,2020,2,5,11.31536087,1136,15.1718842975,1210,13.3044458433,2346
CT,2020,2,6,19.95183517,534,17.5987984111,1007,18.4141920706,1541
CT,2020,2,7,8.876013733,582,11.6036363636,407,9.99850353145,989
CT,2020,2,8,17.21000899,1106,19.3791108987,1046,18.2643215348,2152
CT,2020,2,9,12.41503921,1020,17.3500288462,1040,14.9064902884,2060
CT,2020,2,10,11.6096612,974,25.6069730942,892,18.3007663498,1866
CT,2020,2,11,11.58142124,978,18.2827330508,944,14.8728043563,1922
CT,2020,2,12,11.73611873,1010,12.0587641723,882,11.8865274404,1892
CT,2020,2,13,11.37903921,1124,11.4218556701,1067,11.3998904939,2191
CT,2020,2,14,14.5008091,1100,12.4687297297,1110,13.4801719502,2210
CT,2020,2,15,17.38332343,1011,15.9594635628,988,16.6795847863,1999
CT,2020,2,16,17.37279403,1020,18.7818241042,921,18.0413755335,1941
CT,2020,2,17,13.38451612,1085,14.1081324111,1012,13.7337291322,2097
CT,2020,2,18,15.67353147,1161,9.7218788501,974,12.9583513052,2135
CT,2020,2,19,12.18591468,1148,13.7966695205,1168,12.9982470003,2316
CT,2020,2,20,15.10289604,1143,17.1218503937,1016,16.0529922064,2159
CT,2020,2,21,16.20412435,1062,17.2490401567,1021,16.7162986364,2083
CT,2020,2,22,13.15282318,1052,15.8339857369,1262,14.6150648165,2314
CT,2020,2,23,19.84164083,1030,20.92498,1000,20.3753054458,2030
CT,2020,2,24,14.12656083,1102,16.0058018386,979,15.0106439378,2081
CT,2020,2,25,9.749147975,1115,15.1560037175,1076,12.4044545834,2191
CT,2020,2,26,11.5669864,1105,24.9013521401,1028,17.9934880319,2133
CT,2020,2,27,15.80983239,1133,16.8877371542,1012,16.31838233,2145
CT,2020,2,28,14.68775798,1124,17.958222638,1069,16.2819790103,2193
CT,2020,2,29,22.19889727,1070,11.2031945789,1033,16.7977746452,2103
CT,2020,3,1,19.19716159,1064,18.5664919355,992,18.8928696166,2056
CT,2020,3,2,12.22757276,1100,14.1334199584,962,13.1167216469,2062
CT,2020,3,3,16.00707075,1089,13.9170528267,1079,14.9668819404,2168
CT,2020,3,4,16.47226929,1106,18.0711872587,1036,17.2456021637,2142
CT,2020,3,5,13.1813945,1133,10.2167813953,1075,11.7380253481,2208
CT,2020,3,6,16.37408427,1043,16.8794481446,1051,16.6277315633,2094
CT,2020,3,7,18.31532881,1034,21.6804805726,978,19.9510735534,2012
CT,2020,3,8,17.43924142,1002,17.721696905,937,17.5757348648,1939
CT,2020,3,9,8.958262447,1082,13.9570773931,982,11.3365745967,2064
CT,2020,3,10,12.28456966,1127,11.6499421408,1037,11.9804528682,2164
CT,2020,3,11,13.74494001,1247,18.1552833479,1147,15.857999245,2394
CT,2020,3,12,15.55930812,1272,14.5542614601,1178,15.076065277,2450
CT,2020,3,13,10.6113862,1147,13.6998346388,1149,12.1569555625,2296
CT,2020,3,14,8.284045903,1132,15.9919590643,1026,11.9486978509,2158
CT,2020,3,15,9.680197742,1163,11.5601480111,1081,10.5858244091,2244
CT,2020,3,16,7.56334604,1315,13.0076843018,1153,10.1068314597,2468
CT,2020,3,17,4.811604391,1365,7.41497730711,1322,6.09245999022,2687
CT,2020,3,18,6.656934858,1305,7.76596375618,1214,7.19141722497,2519
CT,2020,3,19,6.837119475,1340,12.4694476505,1213,9.51319236056,2553
CT,2020,3,20,7.741014074,1282,13.8682029435,1291,10.8153245406,2573
CT,2020,3,21,3.57368679,1226,8.76859120521,1228,6.17325591057,2454
CT,2020,3,22,5.154920733,1199,10.1261410788,1205,7.64673459187,2404
CT,2020,3,23,4.659944118,1253,2.98339880444,1171,3.85002886958,2424
CT,2020,3,24,4.41434919,1283,9.34153225806,1240,6.83595323455,2523
CT,2020,3,25,2.837575528,1324,5.48516778523,1192,4.09191971346,2516
CT,2020,3,26,6.075877026,1334,11.8912702265,1236,8.87269647964,2570
CT,2020,3,27,4.303780981,1251,13.0624032922,1215,8.61916058687,2466
CT,2020,3,28,3.908075977,1237,10.4898454936,1165,7.10031639615,2402
CT,2020,3,29,6.617175919,1211,9.34594639866,1194,7.97191685568,2405
CT,2020,3,30,4.16440004,1250,4.4749195597,1181,4.31525300288,2431
CT,2020,3,31,4.785864682,1301,6.06783876501,1166,5.391775416,2467
CT,2020,4,1,5.861607842,1275,9.74768396592,1291,7.81676149593,2566
CT,2020,4,2,3.938167819,1239,10.2239238411,1208,7.04123004812,2447
CT,2020,4,3,5.7526303,1228,11.6943206751,1185,8.67053460771,2413
CT,2020,4,4,4.60046256,1189,9.58191945159,1167,7.06793293032,2356
CT,2020,4,5,2.63277572,1106,4.39343311506,1069,3.49812871095,2175
CT,2020,4,6,5.074518545,1184,7.7920942883,1103,6.38518144175,2287
CT,2020,4,7,5.874861665,1265,8.33027684564,1192,7.06609279863,2457
CT,2020,4,8,5.097904325,1150,15.1319949917,1198,10.2175127657,2348
CT,2020,4,9,4.744130251,1121,5.17035928144,1002,4.9452991104,2123
CT,2020,4,10,4.516192652,1111,7.84235084595,1123,6.18820502971,2234
CT,2020,4,11,3.701382814,1092,10.3775708885,1058,6.98668838739,2150
CT,2020,4,12,4.137862395,1090,8.85662721893,1014,6.41201996699,2104
CT,2020,4,13,2.73177464,1127,7.62518832392,1062,5.10582915454,2189
CT,2020,4,14,4.103260864,1150,5.44803370787,1068,4.75078899621,2218
CT,2020,4,15,3.51040872,1150,6.52740574506,1114,4.99492050707,2264
CT,2020,4,16,3.861808563,1139,5.0422842197,1147,4.45411196555,2286
CT,2020,4,17,2.247604361,1102,15.6433888889,1080,8.87796517224,2182
CT,2020,4,18,5.597399068,1065,7.95405180389,1081,6.78451072107,2146
CT,2020,4,19,4.030068085,1028,5.89083011583,1036,4.96405522838,2064
CT,2020,4,20,3.775177435,1099,4.53923686819,1009,4.14089658495,2108
CT,2020,4,21,2.481893554,1146,3.59243518519,1080,3.02070081441,2226
CT,2020,4,22,2.4355739,1150,6.15111641221,1048,4.20713375114,2198
CT,2020,4,23,3.338652076,1187,6.07005390836,1113,4.66041304966,2300
CT,2020,4,24,5.402178134,1033,3.01922390723,1121,4.1620241469,2154
CT,2020,4,25,2.795364615,1001,11.6770464135,948,7.11544380688,1949
CT,2020,4,26,2.513012291,976,7.27802116402,945,4.8570692327,1921
CT,2020,4,27,2.296427174,1016,8.23278415016,959,5.1789417766,1975
CT,2020,4,28,5.183358034,1081,7.6486053719,968,6.34800392131,2049
CT,2020,4,29,5.401362824,1064,9.22274547188,1049,7.29849031933,2113
CT,2020,4,30,5.217931688,1083,6.08373776908,1022,5.63828979482,2105
CT,2020,5,1,5.425253723,1005,11.8657142857,1078,8.7583389302,2083
CT,2020,5,2,3.888264057,962,10.7771581197,936,7.28552688242,1898
CT,2020,5,3,7.869503593,967,7.12088265836,963,7.49596889867,1930
CT,2020,5,4,4.160095771,1044,6.28678125,960,5.17886725795,2004
CT,2020,5,5,4.128759296,1080,13.0202097235,1049,8.50975107547,2129
CT,2020,5,6,5.380019571,1023,10.5624634859,1027,7.97629757128,2050
CT,2020,5,7,6.591810362,1044,6.09955329949,985,6.3528388457,2029
CT,2020,5,8,4.150903847,1040,5.76984097287,1069,4.97150308245,2109
CT,2020,5,9,6.304883253,1028,11.9430058366,1028,9.12394454479,2056
CT,2020,5,10,6.856319029,978,11.3317051153,997,9.11553924575,1975
CT,2020,5,11,6.259282102,989,10.7921320346,924,8.44869837892,1913
CT,2020,5,12,4.935436439,1054,9.38655521783,987,7.08793728893,2041
CT,2020,5,13,3.820195295,973,9.54384995064,1013,6.73966264956,1986
CT,2020,5,14,3.96964789,994,5.9175462963,864,4.87545210046,1858
CT,2020,5,15,4.62806934,1067,4.01178957719,1017,4.32732244999,2084
CT,2020,5,16,6.202831827,1017,9.43803571429,1008,7.81324442867,2025
CT,2020,5,17,4.753218435,957,10.4552953586,948,7.59078742378,1905
CT,2020,5,18,4.029090026,978,7.02573976915,953,5.50801659525,1931
CT,2020,5,19,3.710455482,1010,5.58438669439,962,4.62461462313,1972
CT,2020,5,20,4.59150392,1024,9.68673286991,1007,7.11779419699,2031
CT,2020,5,21,5.869677446,1023,7.94589211618,964,6.87696025529,1987
CT,2020,5,22,9.106647676,1053,7.24751473477,1018,8.19279092363,2071
CT,2020,5,23,5.014033267,962,9.05863879957,933,7.0053878643,1895
CT,2020,5,24,6.747270772,938,8.94496644295,894,7.81972706558,1832
CT,2020,5,25,6.70558802,961,16.8001468927,885,11.5450704698,1846
CT,2020,5,26,6.425490401,989,7.80285263158,950,7.10031975585,1939
CT,2020,5,27,5.681975067,1043,5.99361493124,1018,5.83590489805,2061
CT,2020,5,28,6.061718476,1094,10.1263708087,1014,8.01691651458,2108
CT,2020,5,29,6.76482455,1026,12.3726067212,1101,9.66758344537,2127
CT,2020,5,30,7.641390584,978,10.0967196819,1006,8.88638104393,1984
CT,2020,5,31,9.677360448,985,13.5280346232,982,11.5997610784,1967
CT,2020,6,1,3.725341785,1024,16.1222145669,1016,9.89947058227,2040
CT,2020,6,2,5.135914906,1011,11.3867184466,1030,8.29041154824,2041
CT,2020,6,3,3.970286016,1049,11.3760115607,1038,7.65363202242,2087
CT,2020,6,4,4.607223823,1041,9.32512716175,983,6.89857707497,2024
CT,2020,6,5,9.318695115,981,7.31171936759,1012,8.29959854883,1993
CT,2020,6,6,5.157194144,948,7.60774261603,948,6.38246838002,1896
CT,2020,6,7,7.848794128,879,5.84977802442,901,6.83693260591,1780
CT,2020,6,8,7.078796555,914,12.2923220537,857,9.601660108,1771
CT,2020,6,9,5.048634985,967,5.64239482201,927,5.33924500026,1894
CT,2020,6,10,4.750247882,968,9.47373727088,982,7.12894869219,1950
CT,2020,6,11,7.107530777,976,8.00584521385,982,7.55806437097,1958
CT,2020,6,12,8.000911104,900,7.70292576419,916,7.85060572335,1816
CT,2020,6,13,4.280936814,886,9.61137529138,858,6.90336583555,1744
CT,2020,6,14,7.631737658,892,10.8050468384,854,9.18386024681,1746
CT,2020,6,15,8.247210078,914,6.69865603645,878,7.48848772952,1792
CT,2020,6,16,6.655015797,953,8.45898126464,854,7.50758165719,1807
CT,2020,6,17,9.319897752,978,10.7311670481,874,9.98590712822,1852
CT,2020,6,18,6.6468518,972,8.18951991828,979,7.42095333142,1951
CT,2020,6,19,8.82671564,953,17.9455923159,937,13.3475555582,1890
CT,2020,6,20,8.692905518,974,14.2586138614,909,11.379697278,1883
CT,2020,6,21,9.134900976,959,19.7484378438,909,14.2996252869,1868
CT,2020,6,22,8.296163345,967,15.2189911308,902,11.6371963374,1869
CT,2020,6,23,7.04918979,938,9.85637540453,927,8.44450403379,1865
CT,2020,6,24,6.958483888,963,9.41783118406,853,8.11367289876,1816
CT,2020,6,25,8.272368458,988,14.2302335456,942,11.180300537,1930
CT,2020,6,26,8.373170021,918,13.365213964,888,10.8277298335,1806
CT,2020,6,27,8.573410215,953,10.2360538117,892,9.37724657718,1845
CT,2020,6,28,8.495415781,914,13.0531728665,914,10.7742943238,1828
CT,2020,6,29,7.236951103,961,10.771134133,917,8.96264111288,1878
CT,2020,6,30,4.20042228,971,5.90393370166,905,5.02221217158,1876
CT,2020,7,1,10.35095433,985,18.9966090713,926,14.5403192125,1911
CT,2020,7,2,9.027837545,985,10.1862278761,904,9.58219691997,1889
CT,2020,7,3,7.354229487,915,16.9735744235,954,12.2642643021,1869
CT,2020,7,4,11.27253115,881,7.95010250569,878,9.61415005296,1759
CT,2020,7,5,11.73914963,882,16.9759667093,781,14.1985327563,1663
CT,2020,7,6,8.201072897,960,12.7053483146,890,10.3679945844,1850
CT,2020,7,7,8.741726996,967,12.3533974359,936,10.5181450369,1903
CT,2020,7,8,6.246878254,961,19.1588948498,932,12.6039830967,1893
CT,2020,7,9,7.847594404,1006,16.4803159041,918,11.9665332487,1924
CT,2020,7,10,6.80642706,960,7.650687251,1004,7.23801424521,1964
CT,2020,7,11,9.09232982,940,19.1633217189,861,13.9069461581,1801
CT,2020,7,12,9.462655871,930,11.1684233738,907,10.304861165,1837
CT,2020,7,13,6.977341526,978,15.607926009,892,11.0941764772,1870
CT,2020,7,14,9.171458267,1008,9.99220572641,943,9.56815988372,1951
CT,2020,7,15,7.549863843,955,9.35734759358,935,8.4440423122,1890
CT,2020,7,16,8.457397561,976,12.8564022346,895,10.5616782574,1871
CT,2020,7,17,6.84227274,924,19.5647020585,923,13.2000433198,1847
CT,2020,7,18,11.51220352,835,12.1184173505,853,11.818542618,1688
CT,2020,7,19,13.77596979,861,14.579161529,811,14.1655562136,1672
CT,2020,7,20,9.598685023,981,14.7452540416,866,12.0117487859,1847
CT,2020,7,21,8.197301813,997,12.8191016043,935,10.4340423952,1932
CT,2020,7,22,8.023728715,1054,7.36314343845,983,7.70494848582,2037
CT,2020,7,23,9.699727604,1028,13.157044335,1015,11.4173861855,2043
CT,2020,7,24,12.18733552,927,13.0652991453,936,12.6284380177,1863
CT,2020,7,25,8.091025635,897,19.1577877095,895,13.6182310238,1792
CT,2020,7,26,10.00715075,909,10.3932588235,850,10.1937294097,1759
CT,2020,7,27,8.471521347,940,15.0768181818,880,11.6652912452,1820
CT,2020,7,28,9.904103699,926,9.72800438596,912,9.81672471451,1838
CT,2020,7,29,6.487247708,981,10.6228741866,922,8.49095113061,1903
CT,2020,7,30,8.213583566,999,13.7997529538,931,10.9082590583,1930
CT,2020,7,31,9.921476706,921,14.1099892241,928,12.0236614636,1849
DC,2020,1,1,22.27719126,1385,39.2493558776,1242,30.3013360849,2627
DC,2020,1,2,16.16226105,1433,20.0145646867,1229,17.9408039386,2662
DC,2020,1,3,18.96273361,1434,22.4805825243,1339,20.6613992055,2773
DC,2020,1,4,16.64005935,1347,30.5861512319,1177,23.1434468877,2524
DC,2020,1,5,16.73257526,1429,32.6969422151,1246,24.1686878679,2675
DC,2020,1,6,15.74301425,1609,20.4360741886,1294,17.834925914,2903
DC,2020,1,7,11.61927391,1639,17.8472634445,1469,14.5629407781,3108
DC,2020,1,8,12.44571079,1632,19.7278508772,1368,15.7663666698,3000
DC,2020,1,9,14.42375074,1645,32.3907034483,1450,22.8412245452,3095
DC,2020,1,10,18.07984365,1471,15.4341542817,1413,16.7836026384,2884
DC,2020,1,11,17.58289007,1391,11.4090953947,1216,14.7032067846,2607
DC,2020,1,12,19.33435149,1542,14.323878357,1266,17.0753561245,2808
DC,2020,1,13,12.4451941,1752,18.0182474916,1495,15.0111672508,3247
DC,2020,1,14,14.88891196,1544,18.1225209542,1551,16.509373204,3095
DC,2020,1,15,16.83282531,1529,15.5457260726,1212,16.2637029912,2741
DC,2020,1,16,17.44588962,1703,22.0555902307,1474,19.5846049804,3177
DC,2020,1,17,18.24825565,1588,29.0793918452,1447,23.4122273385,3035
DC,2020,1,18,16.28964642,1442,19.4128830189,1325,17.7852331542,2767
DC,2020,1,19,19.49181565,1443,27.9470359281,1336,23.5566498679,2779
DC,2020,1,20,23.51054586,1594,39.0839714715,1332,30.6000205403,2926
DC,2020,1,21,15.7871584,1742,29.0384463463,1519,21.9597147908,3261
DC,2020,1,22,14.72868073,1804,16.7945215157,1557,15.6856917694,3361
DC,2020,1,23,16.96375144,1826,23.6769454771,1614,20.1134884097,3440
DC,2020,1,24,20.10331345,1669,24.0886704835,1572,22.0363530232,3241
DC,2020,1,25,17.53637525,1487,30.5152692308,1300,23.5903982766,2787
DC,2020,1,26,19.09690188,1559,32.0131860299,1403,25.2149122319,2962
DC,2020,1,27,14.19226486,1669,17.5773290598,1404,15.7388415396,3073
DC,2020,1,28,13.52717766,1807,24.3518030691,1564,18.5493414511,3371
DC,2020,1,29,16.14535025,1856,17.2663887147,1595,16.6634772715,3451
DC,2020,1,30,19.75638725,1813,22.1645200254,1573,20.8751092984,3386
DC,2020,1,31,19.92177357,1528,30.9436392607,1569,25.5056635502,3097
DC,2020,2,1,17.1787946,1485,23.7042284418,1322,20.2520484435,2807
DC,2020,2,2,12.91787799,1197,17.6525167785,1490,15.5433382784,2687
DC,2020,2,3,26.87243609,1174,16.6905680473,845,22.6110797274,2019
DC,2020,2,4,15.93592364,1808,16.5058380414,1593,16.2028667866,3401
DC,2020,2,5,15.46833333,1866,31.5529047072,1742,23.2342211734,3608
DC,2020,2,6,19.51962917,890,28.3536512084,1531,25.1061172909,2421
DC,2020,2,7,9.953463211,872,5.20692913386,635,7.95343060384,1507
DC,2020,2,8,16.31974985,1439,22.4339378238,1351,19.2804193671,2790
DC,2020,2,9,21.4807337,1431,38.7246299094,1324,29.7678184845,2755
DC,2020,2,10,10.45817677,1629,16.1671827795,1324,13.0178530167,2953
DC,2020,2,11,14.52677557,1622,19.1724859463,1601,16.8344958035,3223
DC,2020,2,12,17.04889645,1622,13.6616833205,1301,15.5412795217,2923
DC,2020,2,13,18.23750149,1757,24.5193975115,1527,21.1584683672,3284
DC,2020,2,14,19.80886846,1467,21.1000347222,1440,20.448455463,2907
DC,2020,2,15,14.54238099,1281,23.052972973,1147,18.5628295091,2428
DC,2020,2,16,21.25261271,1244,30.6678932584,1068,25.6018859045,2312
DC,2020,2,17,22.97281775,1416,24.601991453,1170,23.709914901,2586
DC,2020,2,18,13.72687861,1714,24.2312565839,1329,18.3145612677,3043
DC,2020,2,19,16.63859644,1717,19.353888556,1669,17.9769964818,3386
DC,2020,2,20,16.23433046,1628,32.6426652602,1422,23.8843803242,3050
DC,2020,2,21,19.20659587,1507,18.650329912,1364,18.9423162578,2871
DC,2020,2,22,17.32452881,1422,23.0749838397,1547,20.3208083421,2969
DC,2020,2,23,24.43353101,1467,17.2063012618,1268,21.0828446039,2735
DC,2020,2,24,19.59543679,1740,22.0544491228,1425,20.7025750441,3165
DC,2020,2,25,15.30109656,1833,16.5194934446,1678,15.883400739,3511
DC,2020,2,26,16.74436051,1853,19.9956805469,1609,18.2554448368,3462
DC,2020,2,27,16.91085665,1786,19.2252523364,1605,18.0062872241,3391
DC,2020,2,28,26.44703371,1571,28.1964639037,1496,27.3003586431,3067
DC,2020,2,29,21.03738866,1459,25.3240298507,1340,23.0895855859,2799
DC,2020,3,1,20.22993772,1605,27.2009502262,1326,23.3836608805,2931
DC,2020,3,2,19.98324919,1862,25.6943664596,1610,22.6315495368,3472
DC,2020,3,3,18.87267132,1999,23.8064049587,1694,21.1358028618,3693
DC,2020,3,4,20.53318978,1950,20.8578708947,1766,20.6874919459,3716
DC,2020,3,5,17.67384739,1848,27.8032654321,1620,22.4055824616,3468
DC,2020,3,6,22.46488413,1597,21.344302554,1527,21.9171478731,3124
DC,2020,3,7,18.38472889,1476,14.5255896226,1272,16.5984024169,2748
DC,2020,3,8,20.68517911,1591,20.6013467262,1344,20.6467904477,2935
DC,2020,3,9,14.90099889,1842,28.4857553476,1496,20.9893139471,3338
DC,2020,3,10,14.90986208,1958,11.3461936663,1642,13.2844333202,3600
DC,2020,3,11,13.83003504,2001,19.0677401444,1801,16.3111257536,3802
DC,2020,3,12,14.62284483,1965,25.8219450673,1784,19.9520512379,3749
DC,2020,3,13,13.71353012,1677,22.2646158428,1679,17.9916209807,3356
DC,2020,3,14,9.656113324,1500,24.4903486647,1348,16.6773735906,2848
DC,2020,3,15,11.7880745,1584,18.3246455609,1453,14.9153836049,3037
DC,2020,3,16,6.817634824,1632,14.9217326733,1414,10.5796815603,3046
DC,2020,3,17,6.02194845,1709,26.948653088,1522,15.8797152278,3231
DC,2020,3,18,6.200815922,1630,5.77935616438,1460,6.00167959639,3090
DC,2020,3,19,6.125359752,1640,14.4117675051,1471,10.0434908368,3111
DC,2020,3,20,7.41167101,1526,15.2871832884,1484,11.2944817147,3010
DC,2020,3,21,5.747352913,1428,10.1564605067,1342,7.88346207934,2770
DC,2020,3,22,4.957623289,1359,10.7514448669,1315,7.80686613678,2674
DC,2020,3,23,4.847214586,1454,10.7700232739,1289,7.63048122787,2743
DC,2020,3,24,4.707630684,1511,11.2677992832,1395,7.85678250637,2906
DC,2020,3,25,7.064681332,1538,6.55751233263,1419,6.8213019576,2957
DC,2020,3,26,4.451814493,1477,15.097352071,1352,9.53939554831,2829
DC,2020,3,27,5.763984919,1330,19.3411868132,1365,12.6407495148,2695
DC,2020,3,28,5.912264715,1254,21.2261487051,1197,13.3911382916,2451
DC,2020,3,29,8.225637887,1309,13.4087719298,1197,10.701380684,2506
DC,2020,3,30,4.306696099,1359,13.1712559242,1266,8.58194666611,2625
DC,2020,3,31,5.07898135,1394,16.7308585056,1258,10.6061538469,2652
DC,2020,4,1,3.065204403,1370,15.1118830676,1317,8.96973577674,2687
DC,2020,4,2,4.825993991,1333,14.5476669348,1243,9.51700310171,2576
DC,2020,4,3,6.342218644,1262,14.3415684647,1205,10.2494811223,2467
DC,2020,4,4,2.183576989,1163,13.1975202885,1109,7.55966110837,2272
DC,2020,4,5,4.418992366,1181,10.7191236162,1084,7.43415451843,2265
DC,2020,4,6,3.886142377,1278,8.89808435852,1138,6.24689981697,2416
DC,2020,4,7,3.379740447,1310,5.96265188834,1218,4.62419698796,2528
DC,2020,4,8,5.056428572,1218,10.3597179694,1241,7.73287515278,2459
DC,2020,4,9,3.982251057,1155,12.3190250965,1036,7.92424005971,2191
DC,2020,4,10,2.640771211,1180,18.5188561817,1189,10.6099746851,2369
DC,2020,4,11,5.025585688,1144,11.3164049196,1057,8.0466651645,2201
DC,2020,4,12,4.619047634,1134,16.0912356322,1044,10.1181129554,2178
DC,2020,4,13,4.892218563,1217,19.8266492147,1146,12.1350698228,2363
DC,2020,4,14,4.87978263,1242,10.9296341463,1148,7.78573641274,2390
DC,2020,4,15,4.992466285,1261,19.9305867127,1159,12.14671487,2420
DC,2020,4,16,5.206199244,1255,14.2614845705,1199,9.63052161826,2454
DC,2020,4,17,5.148536785,1155,12.0084910486,1173,8.60503435854,2328
DC,2020,4,18,5.702028914,1109,11.829043152,1066,8.70497014512,2175
DC,2020,4,19,4.690828035,1099,14.7517885375,1012,9.51398863594,2111
DC,2020,4,20,4.251087671,1140,12.0833998101,1053,8.01188323983,2193
DC,2020,4,21,4.306805449,1249,10.3192218247,1118,7.14663709582,2367
DC,2020,4,22,5.382398164,1276,16.6578663239,1167,10.7685919187,2443
DC,2020,4,23,4.784038478,1300,16.5268101266,1185,10.3837102702,2485
DC,2020,4,24,6.96064301,1182,23.608105802,1172,15.2490144596,2354
DC,2020,4,25,4.658649628,1059,12.733148688,1029,8.63789269926,2088
DC,2020,4,26,4.394622824,1034,17.7400533049,938,10.7425,1972
DC,2020,4,27,5.701980617,1136,11.0000606673,989,8.16776940278,2125
DC,2020,4,28,8.017765329,1159,21.2811195446,1054,14.3347898854,2213
DC,2020,4,29,6.21552345,1213,16.0630914232,1061,10.8101890699,2274
DC,2020,4,30,3.566423162,1191,10.1522459893,1122,6.76110245825,2313
DC,2020,5,1,5.551724107,1102,25.1312700965,1244,15.9340579565,2346
DC,2020,5,2,5.860197659,1012,11.3402674897,972,8.54498993493,1984
DC,2020,5,3,6.307884865,1007,22.1930769231,923,13.9047927767,1930
DC,2020,5,4,4.673629327,1160,21.2958507463,1005,12.3897182537,2165
DC,2020,5,5,4.803013668,1168,9.48482191781,1095,7.06840475662,2263
DC,2020,5,6,4.937299824,1174,7.62349083896,1037,6.19717322179,2211
DC,2020,5,7,6.868076892,1170,9.90834437086,1057,8.31107766665,2227
DC,2020,5,8,8.424272268,1065,5.90971162791,1075,7.16111680627,2140
DC,2020,5,9,6.032256412,1006,10.3154387755,980,8.14581064978,1986
DC,2020,5,10,6.211752293,993,14.2595071194,913,10.0667366353,1906
DC,2020,5,11,3.701643701,1089,9.65906762295,976,6.51735592755,2065
DC,2020,5,12,5.263898515,1162,22.3973151751,1028,13.3064338239,2190
DC,2020,5,13,5.16387663,1086,14.0810335196,1074,9.59768519453,2160
DC,2020,5,14,7.809917644,1094,16.5296798292,937,11.8327719855,2031
DC,2020,5,15,6.434082202,1144,15.1627352682,1137,10.7850153613,2281
DC,2020,5,16,5.674971706,1060,12.7958916256,1015,9.1582168715,2075
DC,2020,5,17,7.699386988,1044,8.0782290562,943,7.87917967563,1987
DC,2020,5,18,6.888648898,1162,17.7469725639,1057,12.0609103287,2219
DC,2020,5,19,6.215601384,1139,17.6873591874,1083,11.8069216815,2222
DC,2020,5,20,6.333270554,1168,14.7797966728,1082,10.3951111143,2250
DC,2020,5,21,7.207711584,1158,20.907034291,1079,13.8154760904,2237
DC,2020,5,22,8.375561563,1113,9.05619090098,1121,8.71709490583,2234
DC,2020,5,23,4.430730288,1027,23.2751659751,964,13.5548066327,1991
DC,2020,5,24,13.15627462,1012,8.69263378804,953,10.9914656058,1965
DC,2020,5,25,9.687729438,1079,18.6891351889,1006,14.0308537475,2085
DC,2020,5,26,7.848820443,1136,17.4909620991,1029,12.4316212579,2165
DC,2020,5,27,7.178858877,1148,20.0183551402,1070,13.3728449012,2218
DC,2020,5,28,7.839723513,1230,15.0520856611,1074,11.2017360768,2304
DC,2020,5,29,12.68349769,1278,14.687384106,1208,13.6572284987,2486
DC,2020,5,30,7.777601231,1309,20.7796098726,1256,14.1442768076,2565
DC,2020,5,31,9.187344854,1499,26.3702363368,1354,17.3421415829,2853
DC,2020,6,1,9.246578634,1742,37.5618838863,1688,23.1813411022,3430
DC,2020,6,2,8.734994148,1708,18.5559350057,1754,13.7107105733,3462
DC,2020,6,3,5.033556005,1527,19.2443766234,1540,12.1690838016,3067
DC,2020,6,4,11.2300838,1551,19.3696634967,1367,15.0432453646,2918
DC,2020,6,5,11.79837153,1572,33.9351584284,1578,22.8878476334,3150
DC,2020,6,6,8.329799327,1396,20.7381603774,1484,14.7235520349,2880
DC,2020,6,7,10.66574291,1198,30.5459921875,1280,20.9347982269,2478
DC,2020,6,8,7.692548096,1197,15.4293967093,1094,11.3870537193,2291
DC,2020,6,9,7.151752408,1244,19.2329023973,1168,13.0019941938,2412
DC,2020,6,10,7.498730486,1284,18.4481117697,1181,12.7446612349,2465
DC,2020,6,11,10.0455223,1235,23.3333678756,1158,16.4756623654,2393
DC,2020,6,12,7.934885225,1089,15.105747538,1117,11.5658250272,2206
DC,2020,6,13,9.396390343,1025,11.0617954071,958,10.2009581954,1983
DC,2020,6,14,12.75495791,1067,51.984336989,1003,31.763202942,2070
DC,2020,6,15,7.14418156,1179,17.5007942584,1045,12.0104856381,2224
DC,2020,6,16,7.82057122,1243,13.0906227758,1124,10.3231221067,2367
DC,2020,6,17,6.6861489,1249,10.3090287162,1184,8.44919440037,2433
DC,2020,6,18,11.78522572,1307,19.6833623693,1148,15.4785295381,2455
DC,2020,6,19,9.76990354,1244,13.2983935743,1245,11.5348573739,2489
DC,2020,6,20,10.24027433,1130,25.8885082873,1086,17.9090388055,2216
DC,2020,6,21,8.089928031,1111,12.6977054108,998,10.2703746052,2109
DC,2020,6,22,8.344336404,1183,19.395480859,1071,13.5953460363,2254
DC,2020,6,23,6.302087698,1231,28.3956206294,1144,16.9441936658,2375
DC,2020,6,24,7.535932561,1217,22.7150762332,1115,14.7935419926,2332
DC,2020,6,25,9.132645111,1240,20.3529576195,1109,14.4299318594,2349
DC,2020,6,26,7.077403758,1117,27.4101559792,1154,17.4094143539,2271
DC,2020,6,27,8.233186669,1023,24.4681139896,965,16.1138229187,1988
DC,2020,6,28,8.99672558,1020,23.9972479839,992,16.3926093895,2012
DC,2020,6,29,7.765610563,1130,14.7534331337,1002,11.0497560676,2132
DC,2020,6,30,8.533124462,1133,11.7909816514,1090,10.1305443164,2223
DC,2020,7,1,11.43378754,1101,23.8699817851,1098,17.6434015832,2199
DC,2020,7,2,13.54607205,1082,19.175040404,990,16.2355887829,2072
DC,2020,7,3,13.4434817,1123,28.14481,1000,20.3682712902,2123
DC,2020,7,4,9.790362324,1049,40.8262523901,1046,25.286085956,2095
DC,2020,7,5,9.078871208,1001,24.7729378531,885,16.4432662138,1886
DC,2020,7,6,7.597676441,1162,14.6756092649,993,10.8591090601,2155
DC,2020,7,7,7.974365113,1205,29.0121296296,1080,17.9178161756,2285
DC,2020,7,8,9.230953223,1175,14.4233268859,1034,11.6614260014,2209
DC,2020,7,9,6.419025025,1159,22.1379284369,1062,13.9352228744,2221
DC,2020,7,10,8.231924512,1060,20.985392062,1033,14.5263975073,2093
DC,2020,7,11,10.79134272,998,31.0970665213,917,20.5147624201,1915
DC,2020,7,12,9.974536565,1025,13.6534782609,874,11.6677409053,1899
DC,2020,7,13,8.58936885,1125,13.7480876494,1004,11.022132436,2129
DC,2020,7,14,5.622982562,1150,20.7246543779,1085,12.9542192153,2235
DC,2020,7,15,8.604812811,1149,17.0284900542,1106,12.7363369933,2255
DC,2020,7,16,10.66369227,1170,22.1895246971,1073,16.1773874079,2243
DC,2020,7,17,11.82448559,1079,23.661986166,1012,17.5535867774,2091
DC,2020,7,18,11.45123847,977,33.854315139,971,22.6182751464,1948
DC,2020,7,19,8.086297686,1021,27.0742857143,903,16.998019718,1924
DC,2020,7,20,9.615157254,1113,20.9255761317,972,14.8879280689,2085
DC,2020,7,21,7.661942482,1148,17.6029195631,1007,12.307215763,2155
DC,2020,7,22,9.292431109,1271,22.5718482143,1120,15.5128188789,2391
DC,2020,7,23,9.341874511,1259,28.1509535452,1227,18.6253580086,2486
DC,2020,7,24,13.36729873,1081,22.769875717,1046,17.9912270461,2127
DC,2020,7,25,8.003710676,954,31.5270620843,902,19.4358566729,1856
DC,2020,7,26,10.48013103,992,26.7275821596,852,17.9870878426,1844
DC,2020,7,27,12.80697776,1125,22.2679256966,969,17.1850381948,2094
DC,2020,7,28,9.774286921,1185,10.3637799043,1045,10.0505291486,2230
DC,2020,7,29,6.684834986,1212,20.6193853659,1025,13.0696870823,2237
DC,2020,7,30,12.32802292,1133,13.1409270927,1111,12.730490182,2244
DC,2020,7,31,11.35119883,951,18.8052609159,939,15.0545661838,1890
DE,2020,1,1,24.901629,221,31.2475111111,225,28.103026926,446
DE,2020,1,2,38.62244867,196,16.6773913043,184,27.9964208929,380
DE,2020,1,3,22.14283436,187,23.9619339623,212,23.109373497,399
DE,2020,1,4,23.97821615,213,16.8909708738,206,20.4937948447,419
DE,2020,1,5,12.71432176,199,17.2032380952,210,15.0191443282,409
DE,2020,1,6,18.86194014,201,22.9252040816,196,20.8679848064,397
DE,2020,1,7,14.46957936,214,29.9909345794,214,22.2302569697,428
DE,2020,1,8,25.48099979,210,16.1482914573,199,20.9401465914,409
DE,2020,1,9,18.46742724,206,31.4046153846,208,24.967270559,414
DE,2020,1,10,19.01942473,226,31.8391219512,205,25.1169605313,431
DE,2020,1,11,19.55334803,230,16.91595,200,18.3266512719,430
DE,2020,1,12,19.73778325,203,16.3567857143,196,18.0769423553,399
DE,2020,1,13,14.94752427,206,20.0083486239,218,17.5495518859,424
DE,2020,1,14,7.110499997,160,20.1919607843,204,14.4418681305,364
DE,2020,1,15,20.53993228,148,12.5362937063,143,16.6068727747,291
DE,2020,1,16,17.04815921,201,20.5939336493,211,18.8640776728,412
DE,2020,1,17,17.93156408,211,16.7505641026,195,17.3643350268,406
DE,2020,1,18,17.7851689,207,17.080990566,212,17.4288781916,419
DE,2020,1,19,29.76138237,217,14.9296335079,191,22.8180881723,408
DE,2020,1,20,21.60317962,217,22.7574074074,189,22.1404925555,406
DE,2020,1,21,21.81251052,235,19.5162962963,216,20.712771557,451
DE,2020,1,22,19.12504501,222,27.5213875598,209,23.1965893091,431
DE,2020,1,23,21.23977495,222,15.1157635468,203,18.3146589151,425
DE,2020,1,24,23.86914825,223,30.6498214286,224,27.2670694849,447
DE,2020,1,25,25.51948461,194,16.8740322581,186,21.2877631956,380
DE,2020,1,26,26.49615381,208,15.1885643564,202,20.9250975426,410
DE,2020,1,27,19.94702931,239,26.7825388601,193,23.0008564933,432
DE,2020,1,28,8.796652712,239,24.3430901288,233,16.4710593182,472
DE,2020,1,29,17.62062485,208,15.6525120773,207,16.6389396839,415
DE,2020,1,30,26.93110605,217,18.9153181818,220,22.8956979699,437
DE,2020,1,31,25.48644863,214,21.7396444444,225,23.5661047991,439
DE,2020,2,1,28.78258702,201,21.258364486,214,24.9026264844,415
DE,2020,2,2,26.06733836,139,13.1575545852,229,18.0338044349,368
DE,2020,2,3,14.10664111,131,13.8930973451,113,14.0077458418,244
DE,2020,2,4,9.391256871,183,16.4948214286,168,12.7912535823,351
DE,2020,2,5,19.64935649,202,16.5291701245,241,17.9519187607,443
DE,2020,2,6,27.31931034,87,18.7981025641,195,21.4269858141,282
DE,2020,2,7,18.50672272,119,4.26970588235,68,13.3296256881,187
DE,2020,2,8,20.0410408,221,25.7766203704,216,22.8760183451,437
DE,2020,2,9,13.05589471,190,17.6249206349,189,15.3343799338,379
DE,2020,2,10,8.617794119,204,18.1018226601,203,13.3481572488,407
DE,2020,2,11,12.42733327,210,18.6615740741,216,15.5883567763,426
DE,2020,2,12,13.6321001,200,15.7871098266,173,14.6316086327,373
DE,2020,2,13,21.75514762,237,16.8771945701,221,19.4013755152,458
DE,2020,2,14,18.59778843,208,18.9165384615,208,18.7571634458,416
DE,2020,2,15,10.94720381,211,17.6133507853,191,14.114452746,402
DE,2020,2,16,18.156602,206,17.9462371134,194,18.05457503,400
DE,2020,2,17,21.48289603,221,18.6978947368,228,20.0686860192,449
DE,2020,2,18,16.6190826,218,20.7751904762,210,18.6582944084,428
DE,2020,2,19,24.68676601,235,16.9582629108,213,21.0122768133,448
DE,2020,2,20,20.28718342,213,47.6039224138,232,34.528719255,445
DE,2020,2,21,25.37005014,200,17.8676605505,218,21.4573206411,418
DE,2020,2,22,20.15266672,210,15.9368835616,292,17.7004581896,502
DE,2020,2,23,25.47055861,179,33.0857219251,187,29.3613660961,366
DE,2020,2,24,25.22040019,200,32.5693820225,178,28.6810318466,378
DE,2020,2,25,11.60832491,197,28.7737440758,211,20.4855392335,408
DE,2020,2,26,24.29483063,207,15.8105752212,226,19.8665587538,433
DE,2020,2,27,15.17360579,208,14.5476315789,190,14.8747738802,398
DE,2020,2,28,19.36775342,227,14.9308636364,220,17.1840492759,447
DE,2020,2,29,24.10746272,201,25.7663551402,214,24.9628915825,415
DE,2020,3,1,17.00670045,197,29.2221787709,179,22.8220478422,376
DE,2020,3,2,22.60648226,199,22.2654773869,199,22.4359798235,398
DE,2020,3,3,13.17052875,208,14.3977941176,204,13.778203835,412
DE,2020,3,4,27.09897742,225,16.7759624413,213,22.0788810947,438
DE,2020,3,5,32.50784308,204,19.8143231441,229,25.7946420054,433
DE,2020,3,6,17.30442307,208,22.6864210526,190,19.8737185893,398
DE,2020,3,7,18.10340002,200,11.6888481675,191,14.9699488593,391
DE,2020,3,8,23.16231886,207,19.6538764045,178,21.5402337767,385
DE,2020,3,9,16.95810814,185,38.545025641,195,28.0356052787,380
DE,2020,3,10,15.55796303,216,22.8784020619,194,19.0217805231,410
DE,2020,3,11,23.10527644,235,24.9225210084,238,24.0196616562,473
DE,2020,3,12,22.51746617,221,19.0960245902,244,20.7221290829,465
DE,2020,3,13,18.01626326,190,26.1094949495,198,22.146314483,388
DE,2020,3,14,13.0540659,182,20.9689617486,183,17.0223561474,365
DE,2020,3,15,40.38341991,193,14.5121978022,182,27.827253447,375
DE,2020,3,16,18.90303024,231,21.5247619048,231,20.2138960724,462
DE,2020,3,17,11.11030055,233,13.6645833333,240,12.4063425542,473
DE,2020,3,18,17.12755458,229,11.9181105991,217,14.5929147956,446
DE,2020,3,19,15.45468746,224,17.3975221239,226,16.4304222023,450
DE,2020,3,20,12.33279622,211,16.9077777778,216,14.6470726052,427
DE,2020,3,21,8.934947938,192,14.20005,200,11.6212245002,392
DE,2020,3,22,3.737900062,200,22.6625462963,216,13.5641586837,416
DE,2020,3,23,9.218693847,222,17.525,218,13.3340909864,440
DE,2020,3,24,7.204212928,216,7.99063106796,206,7.58810424751,422
DE,2020,3,25,7.261078484,204,21.0846728972,214,14.3382296908,418
DE,2020,3,26,6.717720976,215,35.6758536585,205,20.8520476425,420
DE,2020,3,27,3.934250018,200,9.43112149533,214,6.77562802802,414
DE,2020,3,28,12.46420536,195,23.5828985507,207,18.1895026,402
DE,2020,3,29,7.395102043,196,9.26226130653,199,8.33577215298,395
DE,2020,3,30,9.442512652,199,14.1793596059,203,11.8345025317,402
DE,2020,3,31,4.765087744,228,12.7929906542,214,8.65190046523,442
DE,2020,4,1,5.748767084,219,13.2394545455,220,9.50264234942,439
DE,2020,4,2,8.264504934,202,14.248254717,212,11.3286473349,414
DE,2020,4,3,15.61067631,207,18.1770873786,206,16.8907748091,413
DE,2020,4,4,8.677936542,189,10.5592708333,192,9.62601051559,381
DE,2020,4,5,5.674943123,176,11.6032972973,185,8.71301936191,361
DE,2020,4,6,4.150152331,197,12.4617241379,203,8.36827502302,400
DE,2020,4,7,3.85761477,218,9.67421052632,190,6.56632357809,408
DE,2020,4,8,9.334684376,190,8.68206422018,218,8.98598046922,408
DE,2020,4,9,15.03674048,181,23.406,170,19.0902279968,351
DE,2020,4,10,8.821436135,188,16.8727040816,196,12.9309374828,384
DE,2020,4,11,3.557729741,185,8.57313953488,172,5.9741176529,357
DE,2020,4,12,4.415511425,176,7.9398974359,195,6.26795151159,371
DE,2020,4,13,12.07271192,177,10.7185405405,185,11.3806630106,362
DE,2020,4,14,5.010059229,169,11.8654594595,185,8.59268364322,354
DE,2020,4,15,7.623785281,177,9.60894472362,199,8.67444147536,376
DE,2020,4,16,5.816197949,192,26.1405882353,187,15.8443271932,379
DE,2020,4,17,5.775593161,177,13.7206451613,186,9.84661154131,363
DE,2020,4,18,5.725344951,174,9.61983957219,187,7.74271474093,361
DE,2020,4,19,3.310434733,184,10.831396648,179,7.01911843215,363
DE,2020,4,20,3.197461105,193,9.86412087912,182,6.43301331537,375
DE,2020,4,21,5.568967396,184,9.94589285714,168,7.65795454791,352
DE,2020,4,22,7.808477047,197,14.1491666667,180,10.8358620113,377
DE,2020,4,23,5.081207718,207,11.8014634146,205,8.42502426608,412
DE,2020,4,24,5.347729656,185,10.2432075472,212,7.96193951224,397
DE,2020,4,25,12.19319024,163,11.3747777778,180,11.7637026505,343
DE,2020,4,26,10.32862067,174,13.1265853659,164,11.6862130076,338
DE,2020,4,27,4.98255549,180,9.41261780105,191,7.26326142372,371
DE,2020,4,28,6.827365605,186,10.4689583333,192,8.67706349876,378
DE,2020,4,29,7.231040497,173,9.22610810811,185,8.26201118989,358
DE,2020,4,30,9.497499839,200,17.5271808511,188,13.3881700201,388
DE,2020,5,1,7.084680831,188,12.1725,220,9.82811273585,408
DE,2020,5,2,12.79775855,174,12.8176436782,174,12.8077011141,348
DE,2020,5,3,5.260380403,184,13.7815028902,173,9.38966384917,357
DE,2020,5,4,4.884971802,177,26.1732022472,178,15.5590704478,355
DE,2020,5,5,5.677430126,179,25.2826229508,183,15.5883425209,362
DE,2020,5,6,8.258359995,189,17.1700561798,178,12.5806540574,367
DE,2020,5,7,10.92824741,194,22.1501578947,190,16.4807552019,384
DE,2020,5,8,9.677485433,171,10.2289047619,210,9.98141734657,381
DE,2020,5,9,7.714069881,172,25.7495953757,173,16.7579710711,345
DE,2020,5,10,8.252558141,172,13.2318072289,166,10.6979881664,338
DE,2020,5,11,6.684430327,158,39.7347305389,167,23.6671999744,325
DE,2020,5,12,4.40469881,166,12.6573988439,173,8.61625369457,339
DE,2020,5,13,9.635776458,161,11.9576086957,184,10.8740869847,345
DE,2020,5,14,12.46753075,162,27.1489208633,139,19.2473089086,301
DE,2020,5,15,7.112999997,170,13.0521428571,168,10.0649999985,338
DE,2020,5,16,17.23506236,160,14.1526470588,170,15.6471514473,330
DE,2020,5,17,6.657152782,144,11.2561875,160,9.07769737042,304
DE,2020,5,18,17.76307234,166,15.3431818182,154,16.5985000264,320
DE,2020,5,19,6.302236045,161,12.6308280255,157,9.42672956995,318
DE,2020,5,20,7.193491075,169,26.691030303,165,16.8255089571,334
DE,2020,5,21,18.25690038,171,15.6666298343,181,16.9249714914,352
DE,2020,5,22,7.696319105,163,16.6617837838,185,12.4624425693,348
DE,2020,5,23,8.599312559,160,26.204,165,17.5370769521,325
DE,2020,5,24,15.69430369,158,13.2108965517,145,14.5058745314,303
DE,2020,5,25,9.102662332,154,18.3112258065,155,13.7218446574,309
DE,2020,5,26,16.34851047,141,23.6552380952,147,20.0779860287,288
DE,2020,5,27,13.04503189,157,15.4766216216,148,14.2249508417,305
DE,2020,5,28,4.470892875,168,15.6974033149,181,10.2932378309,349
DE,2020,5,29,14.81405713,175,30.8406214689,177,22.8728693118,352
DE,2020,5,30,17.02261083,203,14.6190909091,198,15.8358354077,401
DE,2020,5,31,19.03923903,184,12.2329032258,186,15.6176756257,370
DE,2020,6,1,15.51877005,187,17.5357560976,205,16.5735714269,392
DE,2020,6,2,7.570558676,179,20.0326923077,182,13.8534072105,361
DE,2020,6,3,11.23926388,163,20.4041573034,178,16.023284494,341
DE,2020,6,4,14.90942189,173,15.4401142857,175,15.176293066,348
DE,2020,6,5,15.87146357,164,19.1813125,160,17.5059568688,324
DE,2020,6,6,17.39208583,163,38.7832727273,165,28.1528963119,328
DE,2020,6,7,19.96699397,163,16.7398765432,162,18.3584000526,325
DE,2020,6,8,10.708375,160,18.9855844156,154,14.7678980892,314
DE,2020,6,9,15.17923078,195,27.0902688172,186,20.994068247,381
DE,2020,6,10,14.7217934,184,16.5921348315,178,15.6414640486,362
DE,2020,6,11,18.72876349,186,26.2615337423,163,22.2469341236,349
DE,2020,6,12,16.24862844,175,45.0731168831,154,29.7409421793,329
DE,2020,6,13,17.67460614,165,28.8686127168,173,23.404082879,338
DE,2020,6,14,27.37897422,156,29.1435294118,170,28.2991410378,326
DE,2020,6,15,11.15234932,166,24.0367080745,161,17.4960244254,327
DE,2020,6,16,12.36903033,165,15.1456043956,182,13.8253314249,347
DE,2020,6,17,28.03298791,164,23.4471084337,166,25.7261515674,330
DE,2020,6,18,17.75890543,201,31.7883838384,198,24.7209022342,399
DE,2020,6,19,17.39682371,170,14.2305555556,180,15.7684572306,350
DE,2020,6,20,20.37016484,182,23.6611180124,161,21.9148979617,343
DE,2020,6,21,17.4180526,190,28.7257512953,193,23.1161879739,383
DE,2020,6,22,16.53105535,180,17.1405084746,177,16.8332211849,357
DE,2020,6,23,7.746818221,176,20.2787692308,195,14.333692741,371
DE,2020,6,24,9.467729704,185,18.9192528736,174,14.0486907945,359
DE,2020,6,25,26.02411736,170,32.731091954,174,29.4165986953,344
DE,2020,6,26,16.28524099,166,36.2207471264,174,26.4875294245,340
DE,2020,6,27,13.66662781,172,29.1291907514,173,21.4203187922,345
DE,2020,6,28,17.62393941,165,21.3395402299,174,19.5310619547,339
DE,2020,6,29,12.14227038,185,17.9832608696,184,15.0548510035,369
DE,2020,6,30,6.455388563,193,21.6435909091,220,14.5459563987,413
DE,2020,7,1,12.1916842,190,21.6585915493,213,17.1952853548,403
DE,2020,7,2,13.63299495,197,20.886011236,178,17.0757600137,375
DE,2020,7,3,15.53302704,185,23.8274731183,186,19.6914285779,371
DE,2020,7,4,17.28981131,159,18.4434567901,162,17.8720249168,321
DE,2020,7,5,20.01275182,149,45.0491612903,155,32.7780263855,304
DE,2020,7,6,20.70222904,166,36.9671345029,171,28.9553413075,337
DE,2020,7,7,24.53028423,176,15.898547486,179,20.1779437309,355
DE,2020,7,8,18.60095223,189,15.61,186,17.1174399239,375
DE,2020,7,9,18.25162698,209,23.6132402235,179,20.7251547392,388
DE,2020,7,10,14.04310736,177,18.9148019802,202,16.639630614,379
DE,2020,7,11,14.68373563,174,22.7114201183,169,18.6390670543,343
DE,2020,7,12,10.98581826,165,23.1157831325,166,17.069123906,331
DE,2020,7,13,10.14901037,192,16.9555614973,187,13.5073878392,379
DE,2020,7,14,9.318756814,185,18.4014917127,181,13.8104918322,366
DE,2020,7,15,11.177174,184,14.8768393782,193,13.0711671512,377
DE,2020,7,16,9.95804237,189,17.2715816327,196,13.6812987219,385
DE,2020,7,17,15.98472228,180,17.8030588235,170,16.8679143154,350
DE,2020,7,18,30.64506412,156,25.5089864865,148,28.1446052721,304
DE,2020,7,19,19.40411033,163,22.4849342105,152,20.8907301073,315
DE,2020,7,20,27.75468088,188,16.7588888889,171,22.5171309344,359
DE,2020,7,21,10.15258429,178,16.6957065217,184,13.4783701757,362
DE,2020,7,22,9.591052533,171,21.9632919255,161,15.5908433227,332
DE,2020,7,23,17.79798839,174,16.3616304348,184,17.0597485471,358
DE,2020,7,24,16.10717652,170,32.1448730964,197,24.7159673253,367
DE,2020,7,25,26.89143659,181,35.831871345,171,31.2346591557,352
DE,2020,7,26,13.71500006,170,43.4182352941,170,28.5666176771,340
DE,2020,7,27,10.95034093,176,23.7169346734,199,17.7251466765,375
DE,2020,7,28,10.61672845,162,18.3308839779,181,14.6874635828,343
DE,2020,7,29,21.44133726,172,26.3341875,160,23.7993373757,332
DE,2020,7,30,18.6459639,166,15.9519459459,185,17.2260399071,351
DE,2020,7,31,27.61352593,173,29.0008839779,181,28.3228813161,354
FL,2020,1,1,46.59488892,8106,53.1031119607,9155,50.0467620408,17261
FL,2020,1,2,38.61037984,8056,46.6282003187,8157,42.6442638618,16213
FL,2020,1,3,36.42952553,8030,49.1868529714,8767,43.088065131,16797
FL,2020,1,4,33.46770817,8059,42.3254072081,8546,38.0264492708,16605
FL,2020,1,5,36.17134643,7836,41.7580039803,8542,39.0850861293,16378
FL,2020,1,6,29.31946382,8150,44.5522084188,8291,37.0011550473,16441
FL,2020,1,7,22.75651767,8299,38.4723099449,8537,30.7254959695,16836
FL,2020,1,8,28.04108863,8322,43.6914526341,8371,35.8892403749,16693
FL,2020,1,9,29.78850875,8389,42.570330351,8718,36.3023288656,17107
FL,2020,1,10,33.26919978,7748,46.878825441,8616,40.4349621056,16364
FL,2020,1,11,31.36737156,7628,40.5023348405,7962,36.03270688,15590
FL,2020,1,12,32.16778073,7944,45.1322396213,8238,38.767781493,16182
FL,2020,1,13,27.21601629,8427,47.5056742974,8824,37.5943098531,17251
FL,2020,1,14,23.05131933,6799,42.2636105926,8572,33.7655058308,15371
FL,2020,1,15,33.10403854,6490,32.284874552,5859,32.7153850615,12349
FL,2020,1,16,31.230204,8038,38.9057768924,8032,35.0665575452,16070
FL,2020,1,17,34.93597167,7636,46.6665587614,8526,41.1242519287,16162
FL,2020,1,18,29.43054823,7515,45.8371985019,8010,37.8954286601,15525
FL,2020,1,19,36.01761659,7724,41.7437332529,8285,38.9810044688,16009
FL,2020,1,20,34.14525702,7919,46.6311477833,8120,40.466438702,16039
FL,2020,1,21,28.26142638,8399,40.15465768,8457,34.2285038067,16856
FL,2020,1,22,29.27164752,8437,43.7782138833,8874,36.7080330499,17311
FL,2020,1,23,33.0732482,8226,44.9534472866,8366,39.0634691233,16592
FL,2020,1,24,32.50925796,7695,48.2478335099,8493,40.7664683718,16188
FL,2020,1,25,31.49131694,8019,40.3497696954,7946,35.9002906697,15965
FL,2020,1,26,37.42272987,7982,43.7401823677,9596,40.8714882138,17578
FL,2020,1,27,26.80430383,7944,44.2620401124,7828,35.4689728396,15772
FL,2020,1,28,27.29091593,8199,40.2143889022,8362,33.8162514166,16561
FL,2020,1,29,29.3337303,8203,40.0341644753,8366,34.7365809434,16569
FL,2020,1,30,35.2980475,8558,43.92425512,8545,39.6078729173,17103
FL,2020,1,31,39.06888208,8212,49.5196542727,9198,44.5902033108,17410
FL,2020,2,1,40.32679277,8743,55.4495373015,8753,47.8924868077,17496
FL,2020,2,2,33.36500642,6218,49.6286480869,10585,43.6102392382,16803
FL,2020,2,3,54.82392213,5074,42.9428542673,4968,48.9460944919,10042
FL,2020,2,4,24.85880535,7542,33.1410988063,6953,28.8316778165,14495
FL,2020,2,5,27.37874936,8308,43.1282143625,9302,35.6979727248,17610
FL,2020,2,6,44.39993436,3809,38.0088498242,7964,40.076601544,11773
FL,2020,2,7,18.9090498,4073,23.2801258695,3019,20.7697771906,7092
FL,2020,2,8,29.63594022,7626,43.1859958708,8234,36.6706916846,15860
FL,2020,2,9,39.43705327,7174,41.7254748672,8097,40.6504217248,15271
FL,2020,2,10,22.88321791,7418,43.4593706477,7611,33.3034121004,15029
FL,2020,2,11,23.80748893,7212,38.4516049693,7969,31.4946611003,15181
FL,2020,2,12,27.4363001,7503,38.9223175599,7016,32.9866753668,14519
FL,2020,2,13,35.36586959,8636,45.8913160933,8662,40.6365030512,17298
FL,2020,2,14,34.56326804,8011,49.2395866756,8976,42.318294594,16987
FL,2020,2,15,31.90273378,7466,38.3219482306,7997,35.2225590378,15463
FL,2020,2,16,36.1804143,7387,42.6431858296,7932,39.5267622191,15319
FL,2020,2,17,34.52074696,7792,46.7084211168,8202,40.7707971935,15994
FL,2020,2,18,27.30474087,8298,42.7004874446,8124,34.9210510132,16422
FL,2020,2,19,25.23193594,8301,43.7100555367,8823,34.7526349123,17124
FL,2020,2,20,33.89106953,7929,42.3537662654,8223,38.1994372402,16152
FL,2020,2,21,35.55549692,7386,45.7174470471,8026,40.8474649787,15412
FL,2020,2,22,30.98897575,7362,41.9389617268,10007,37.2977160154,17369
FL,2020,2,23,34.99451121,7344,45.5869295667,7823,40.4579838021,15167
FL,2020,2,24,31.83485167,8158,47.4090203578,8105,39.5965584409,16263
FL,2020,2,25,26.0053149,8209,45.063873403,8610,35.7617920218,16819
FL,2020,2,26,32.0225626,7949,45.06679737,8365,38.7109911798,16314
FL,2020,2,27,38.1112598,7930,46.7250381679,8122,42.4696642296,16052
FL,2020,2,28,37.7753389,7582,46.0042681029,8355,42.0893693631,15937
FL,2020,2,29,39.54275498,7176,42.0433371126,7938,40.856081761,15114
FL,2020,3,1,40.05496455,7181,46.3384353832,7529,43.2710251824,14710
FL,2020,3,2,36.03500257,7818,44.3527737409,7982,40.237056335,15800
FL,2020,3,3,28.75771881,7943,46.4657008536,8083,37.6890565648,16026
FL,2020,3,4,34.77585782,8201,43.5250959233,8340,39.1872383763,16541
FL,2020,3,5,34.26813555,8051,46.7543859235,8468,40.6688600589,16519
FL,2020,3,6,38.76291702,7518,47.9031793641,8335,43.5685744122,15853
FL,2020,3,7,35.80839864,7375,46.0908353132,7997,41.1576470186,15372
FL,2020,3,8,43.43288773,7144,46.6203173152,7658,45.081944328,14802
FL,2020,3,9,34.01191166,7810,47.3524738024,8016,40.7690168119,15826
FL,2020,3,10,27.17151058,8421,43.9093124118,8508,35.5834202017,16929
FL,2020,3,11,30.44483075,9543,40.7369435287,9403,35.5528607541,18946
FL,2020,3,12,34.31193464,9630,43.4534735096,10249,39.0250304635,19879
FL,2020,3,13,34.22889076,8564,45.6941769016,9689,40.3148578573,18253
FL,2020,3,14,32.12510856,8196,45.7827190542,8628,39.1292611601,16824
FL,2020,3,15,36.53723378,8347,46.365400413,8716,41.5575877842,17063
FL,2020,3,16,27.81633042,9279,44.132954003,9218,35.9477374692,18497
FL,2020,3,17,19.28551631,9559,37.6695600313,10228,28.7883211405,19787
FL,2020,3,18,18.20937975,9416,36.1061296082,9521,27.2073707412,18937
FL,2020,3,19,16.75282849,9528,32.3948342541,9412,24.5259308264,18940
FL,2020,3,20,16.13299109,9321,30.7443213128,9872,23.6483900354,19193
FL,2020,3,21,16.81229529,8831,27.1042879308,9023,22.0136311026,17854
FL,2020,3,22,14.21499533,8492,25.604979855,8687,19.9746318378,17179
FL,2020,3,23,10.54833723,8985,22.8429266329,8696,16.5951529897,17681
FL,2020,3,24,10.97396461,9320,22.5070545494,9221,16.70971901,18541
FL,2020,3,25,11.30551974,9245,26.9041171944,9096,19.0414579356,18341
FL,2020,3,26,9.707952291,9474,25.2954201459,9461,17.4963353581,18935
FL,2020,3,27,9.510185153,8965,23.0113730929,9373,16.4109722923,18338
FL,2020,3,28,9.012620416,8617,21.6147117159,8672,15.3337110373,17289
FL,2020,3,29,8.928326961,8613,21.421123454,8732,15.2175802891,17345
FL,2020,3,30,9.086568292,8943,23.8529600635,8814,16.4161271744,17757
FL,2020,3,31,7.906933263,9202,23.6647399955,8846,15.6304238634,18048
FL,2020,4,1,10.11406585,9206,23.7484616997,9543,17.0537980807,18749
FL,2020,4,2,8.853008241,8992,23.0914681284,8848,15.9147735484,17840
FL,2020,4,3,8.978783129,8530,21.7799642937,8962,15.5374491248,17492
FL,2020,4,4,7.098403169,8210,20.8615285783,8328,14.0290663936,16538
FL,2020,4,5,8.474574889,8092,18.8645397363,8267,13.7251305093,16359
FL,2020,4,6,7.389065197,8601,21.1583980758,8315,14.1573320974,16916
FL,2020,4,7,6.869986344,8796,21.1051361015,8670,13.9362149251,17466
FL,2020,4,8,8.592645383,7874,20.5598227848,8690,14.8710063841,16564
FL,2020,4,9,10.51749671,7642,19.8541771805,7292,15.0764276053,14934
FL,2020,4,10,9.208648092,7811,21.6234387643,8157,15.5505473601,15968
FL,2020,4,11,7.674746591,7595,22.601474268,7753,15.2149420354,15348
FL,2020,4,12,8.635724247,7711,21.3363032808,7742,14.9987529715,15453
FL,2020,4,13,7.560774701,8274,20.4084180096,8129,13.9278107588,16403
FL,2020,4,14,7.086748747,8406,21.1648857074,8312,14.0862387826,16718
FL,2020,4,15,8.730032295,8351,21.8868926151,8409,15.3312279055,16760
FL,2020,4,16,8.631736923,8158,20.7199431608,8093,14.6516651171,16251
FL,2020,4,17,8.544781401,7730,24.1781753438,8144,16.5653408233,15874
FL,2020,4,18,7.659979942,7481,21.0588113061,7748,14.476852055,15229
FL,2020,4,19,8.428207197,7441,22.2212699039,7599,15.3971888134,15040
FL,2020,4,20,10.18864725,7762,21.6690644951,7675,15.896505147,15437
FL,2020,4,21,9.093523428,7839,21.7589538026,7771,15.3986521558,15610
FL,2020,4,22,10.26249755,8096,22.1539447075,7813,16.1024545958,15909
FL,2020,4,23,9.69590735,8354,22.6436977568,8470,16.2144394913,16824
FL,2020,4,24,8.776265255,7524,21.4896817625,8170,15.3946297807,15694
FL,2020,4,25,8.271940458,7055,22.4301107617,7313,15.478141699,14368
FL,2020,4,26,8.292529569,6938,20.5829462908,7131,14.5220385351,14069
FL,2020,4,27,7.636104924,7168,20.7260673064,7191,14.1915697538,14359
FL,2020,4,28,7.506720976,7301,22.9238127982,7126,15.1217619634,14427
FL,2020,4,29,9.823722432,7436,22.8110070194,7408,16.305115872,14844
FL,2020,4,30,12.35086346,7505,23.7144008484,7544,18.0473566528,15049
FL,2020,5,1,13.11554796,7026,32.3900730663,7938,23.3401657289,14964
FL,2020,5,2,10.8019264,6738,22.3574988927,6773,16.5946798966,13511
FL,2020,5,3,11.83840868,6812,23.0295244347,6855,17.4515716637,13667
FL,2020,5,4,12.03336887,7409,32.0116257294,7369,21.9954594639,14778
FL,2020,5,5,11.48383871,7380,22.5962568908,7256,16.9929741514,14636
FL,2020,5,6,11.12185813,7373,26.2693937739,7324,18.6703749059,14697
FL,2020,5,7,11.93772529,7469,25.2033572008,7402,18.5406576687,14871
FL,2020,5,8,11.28106497,6911,23.9833126894,7589,17.9291586212,14500
FL,2020,5,9,14.80059582,6730,29.0920724316,6765,21.964866978,13495
FL,2020,5,10,14.92474818,6752,26.7780756649,7031,20.9713813909,13783
FL,2020,5,11,12.65672588,7092,26.2982808149,6823,19.3456464205,13915
FL,2020,5,12,10.91920427,7226,23.619051856,7193,17.2545953294,14419
FL,2020,5,13,9.200691978,6720,24.9646467316,7190,17.3489906608,13910
FL,2020,5,14,11.41011985,6677,26.6738511687,6289,18.8136063735,12966
FL,2020,5,15,13.37316851,6836,25.7251034203,7397,19.7925644583,14233
FL,2020,5,16,11.85536869,6618,26.1328898488,6945,19.1662427185,13563
FL,2020,5,17,13.21779275,6610,27.7618862099,6802,20.5939427436,13412
FL,2020,5,18,14.06604297,7071,24.8192321729,7124,19.4627122114,14195
FL,2020,5,19,11.28803276,7142,27.5110217945,7066,19.3561380892,14208
FL,2020,5,20,11.51933769,7202,28.0314978874,7337,19.8520785503,14539
FL,2020,5,21,16.172596,7165,29.9282673943,7330,23.1287237213,14495
FL,2020,5,22,17.0344575,6820,31.485612424,7405,24.5571852478,14225
FL,2020,5,23,14.36224422,6675,29.926161631,6818,22.2266768079,13493
FL,2020,5,24,17.16665768,6681,29.5512943391,6907,23.4619686459,13588
FL,2020,5,25,17.08433056,6819,27.3401263066,6888,22.2380418829,13707
FL,2020,5,26,14.33370269,7157,26.2331897141,7311,20.3467763445,14468
FL,2020,5,27,14.00416546,7363,28.2288626552,7412,21.1401015419,14775
FL,2020,5,28,13.15190435,7546,28.4682685934,7543,20.8085638694,15089
FL,2020,5,29,16.93115779,7324,28.1395460262,7952,22.7657416637,15276
FL,2020,5,30,13.35341947,7273,29.8205205128,7800,21.8748410937,15073
FL,2020,5,31,17.7754196,7257,28.4935535107,7933,23.3729809109,15190
FL,2020,6,1,15.51700893,7509,32.390625471,7962,24.2008519201,15471
FL,2020,6,2,10.58730649,7466,23.053174705,7796,16.9550111554,15262
FL,2020,6,3,11.35287055,7260,26.9060612806,7637,19.3262690604,14897
FL,2020,6,4,15.02594777,7011,27.7148504892,7257,21.479786222,14268
FL,2020,6,5,14.78882099,6506,26.1834120589,7198,20.7738083305,13704
FL,2020,6,6,13.85923157,6234,28.2652320549,6701,21.3222860153,12935
FL,2020,6,7,14.9636009,6079,30.9158143823,6508,23.211555563,12587
FL,2020,6,8,15.14542293,6515,28.6542610159,6536,21.9107103202,13051
FL,2020,6,9,13.19439675,6805,27.0372595597,6904,20.1658115022,13709
FL,2020,6,10,14.64272421,6857,30.614858798,6905,22.6566458297,13762
FL,2020,6,11,18.67903533,6842,30.8695692051,7196,24.9280082439,14038
FL,2020,6,12,20.09776774,6285,34.3740846087,6926,27.5822708535,13211
FL,2020,6,13,17.25229779,6119,34.1635526928,6443,25.9260133878,12562
FL,2020,6,14,19.49980425,6384,32.1541777446,6695,25.9774424904,13079
FL,2020,6,15,16.05168394,6633,33.315384729,6771,24.7724029822,13404
FL,2020,6,16,13.89850096,6811,31.2923503102,6931,22.6713702546,13742
FL,2020,6,17,15.13575033,6977,29.5063843182,6989,22.3272411608,13966
FL,2020,6,18,17.28448261,7025,30.2638288654,7386,23.9367240535,14411
FL,2020,6,19,18.86220663,6562,33.70241498,7263,26.6585489986,13825
FL,2020,6,20,20.02922318,6488,32.2377507057,6731,26.2456993715,13219
FL,2020,6,21,21.54719181,6442,37.6434546513,6869,29.8534970806,13311
FL,2020,6,22,18.34873347,6798,32.6453707503,6824,25.5106959425,13622
FL,2020,6,23,15.98681442,6834,33.5061319149,7050,24.8827513502,13884
FL,2020,6,24,15.04771256,6763,29.0466351056,6865,22.0995619345,13628
FL,2020,6,25,19.26063508,6818,32.1011993048,6904,25.7211550776,13722
FL,2020,6,26,19.36093984,6533,31.047378998,7066,25.4331789084,13599
FL,2020,6,27,18.42909131,6372,34.8947985676,6702,26.8697498721,13074
FL,2020,6,28,20.76740961,6470,36.2016513485,6637,28.5828565024,13107
FL,2020,6,29,16.90536214,6820,33.3172347499,6918,25.1698354779,13738
FL,2020,6,30,13.7538174,6494,32.6574717251,6985,23.5499465981,13479
FL,2020,7,1,21.10348655,6528,39.1375657519,6996,30.4325621265,13524
FL,2020,7,2,22.62519304,6580,31.7533362702,6810,27.267661703,13390
FL,2020,7,3,20.92325525,6746,33.8908757431,6897,27.4788279643,13643
FL,2020,7,4,19.35386931,6332,33.0974628802,6937,26.538985641,13269
FL,2020,7,5,23.37703059,6220,32.8903372549,6375,28.1922215379,12595
FL,2020,7,6,18.57138846,6770,31.7085081414,6817,25.1626701902,13587
FL,2020,7,7,15.49922902,6913,35.0732576306,6913,25.2862433253,13826
FL,2020,7,8,16.25087967,6957,29.7227259827,7047,23.0300928209,14004
FL,2020,7,9,17.82488638,7040,35.4183075408,7108,26.6638768812,14148
FL,2020,7,10,17.74784878,6587,35.4679351952,7376,27.1085418545,13963
FL,2020,7,11,17.51368411,6471,33.6247725939,6816,25.7783924043,13287
FL,2020,7,12,22.09881837,6508,34.962091055,6853,28.6965286993,13361
FL,2020,7,13,18.89545157,6932,38.1709771847,6969,28.5588670084,13901
FL,2020,7,14,14.76638379,6822,34.3601831143,7154,24.7960088878,13976
FL,2020,7,15,16.92662842,6795,32.8796607754,7016,25.0307827177,13811
FL,2020,7,16,20.61560598,6684,33.5304488099,6974,27.2101376754,13658
FL,2020,7,17,18.519296,6250,34.1405389134,6810,26.6648292496,13060
FL,2020,7,18,14.71333725,5972,34.9472857368,6359,25.1478258095,12331
FL,2020,7,19,18.46025705,6068,32.4039788394,6238,25.5284300162,12306
FL,2020,7,20,17.85780995,6566,32.7614632331,6718,25.3949029006,13284
FL,2020,7,21,17.15941867,6606,34.068414345,6748,25.7038175628,13354
FL,2020,7,22,17.73085411,6802,31.3060351707,6767,24.5009366686,13569
FL,2020,7,23,19.81718495,6817,35.0080722052,7174,27.6064369812,13991
FL,2020,7,24,20.82891062,6297,37.0502209152,6971,29.3515782465,13268
FL,2020,7,25,18.37303488,5987,34.0372913361,6302,26.4059215417,12289
FL,2020,7,26,19.65719937,5931,35.4237592295,6230,27.7343038783,12161
FL,2020,7,27,19.38328237,6474,36.5174588665,6564,28.009508365,13038
FL,2020,7,28,16.63364351,6653,34.459704692,6671,25.558715121,13324
FL,2020,7,29,18.85310818,6795,32.9536755497,6867,25.9405475101,13662
FL,2020,7,30,22.70917369,6874,32.9256204896,7067,27.8881156262,13941
FL,2020,7,31,21.32680949,6209,36.7155068891,6895,29.4239606321,13104
GA,2020,1,1,30.68554433,4134,57.1634310058,4812,44.9278415225,8946
GA,2020,1,2,27.26970231,4165,47.5087909605,4425,37.6955425054,8590
GA,2020,1,3,24.92770813,4132,49.4212614337,4701,37.9633918253,8833
GA,2020,1,4,21.83006156,4067,41.4943985717,4481,32.1384254053,8548
GA,2020,1,5,23.66450389,3870,44.9117177914,4401,34.9701487189,8271
GA,2020,1,6,18.60902112,4117,40.9982765762,4346,30.1065638605,8463
GA,2020,1,7,16.93762132,4162,41.6830457079,4485,29.7725037509,8647
GA,2020,1,8,18.26434927,4180,41.5974511526,4555,30.4317538579,8735
GA,2020,1,9,20.65326387,4179,45.9279957082,4660,33.978328964,8839
GA,2020,1,10,22.00792966,3864,44.7621456954,4530,34.2877245897,8394
GA,2020,1,11,18.58661432,3819,41.3973616104,4173,30.497180942,7992
GA,2020,1,12,24.95091454,4046,40.5860132419,4229,32.9413474597,8275
GA,2020,1,13,18.94303675,4449,43.4300229358,4796,31.6460746891,9245
GA,2020,1,14,15.96424519,3663,37.1974265619,4834,28.0439437603,8497
GA,2020,1,15,21.01978211,3442,32.9995932304,3368,26.9445991223,6810
GA,2020,1,16,21.04818795,4172,40.9473083859,4436,31.3028926728,8608
GA,2020,1,17,26.58561341,4035,45.1644036498,4603,36.4858416427,8638
GA,2020,1,18,21.02796318,3967,39.835160316,4304,30.8147092172,8271
GA,2020,1,19,26.70705891,4036,44.3395062007,4435,35.938543237,8471
GA,2020,1,20,27.27512216,4174,45.8796301339,4407,36.8299603654,8581
GA,2020,1,21,16.99910043,4324,43.3618478028,4665,30.6805128779,8989
GA,2020,1,22,19.60188786,4386,42.4100385604,4668,31.3611597254,9054
GA,2020,1,23,21.40718259,4316,39.4156449497,4574,30.6727289155,8890
GA,2020,1,24,24.42754868,4112,42.7703731995,4582,34.0947699761,8694
GA,2020,1,25,21.70511672,4370,42.2792020224,4549,32.1986153231,8919
GA,2020,1,26,22.00752538,4239,51.8430110603,5244,38.5062374866,9483
GA,2020,1,27,17.06566568,4086,44.1038134016,4298,30.9265863512,8384
GA,2020,1,28,15.46102751,4136,44.1305188154,4491,30.3856462016,8627
GA,2020,1,29,17.44230193,4266,43.1330207414,4532,30.6760297833,8798
GA,2020,1,30,21.58496621,4291,45.7915238506,4633,34.1520865091,8924
GA,2020,1,31,26.02415214,3998,45.8594006923,4622,36.6597111666,8620
GA,2020,2,1,23.00290484,4045,46.8347598669,4206,35.1513453009,8251
GA,2020,2,2,21.31952039,2898,42.6250915597,4751,34.5529847157,7649
GA,2020,2,3,22.10997289,2581,26.812016477,2549,24.4463294404,5130
GA,2020,2,4,14.7359226,3821,31.4555815232,3637,22.8895025817,7458
GA,2020,2,5,16.14284842,4241,38.6220171588,5012,28.3189635955,9253
GA,2020,2,6,28.9846885,1990,37.5720227015,4405,34.8998108077,6395
GA,2020,2,7,15.61609077,2159,20.5742070218,1652,17.7653450466,3811
GA,2020,2,8,20.50538845,4068,39.16673976,4834,30.6389508217,8902
GA,2020,2,9,24.55387553,3762,40.0657726086,4213,32.7484363315,7975
GA,2020,2,10,15.8313903,3956,36.425954491,4175,26.4060189432,8131
GA,2020,2,11,15.84434059,3852,36.9865045662,4380,27.0934511604,8232
GA,2020,2,12,16.86501923,3907,36.8830705178,3843,26.7913896944,7750
GA,2020,2,13,23.76346793,4409,42.9083242298,4577,33.5148597934,8986
GA,2020,2,14,22.77857137,4018,43.5047229219,4764,34.02195397,8782
GA,2020,2,15,22.39827576,3764,39.7053859265,4107,31.4289327863,7871
GA,2020,2,16,30.65161736,3883,39.8389862205,4064,35.3499270428,7947
GA,2020,2,17,21.97629816,4133,43.5506072874,4446,33.1570160036,8579
GA,2020,2,18,18.32373684,4370,41.2648240761,4519,29.9865530421,8889
GA,2020,2,19,18.89315916,4441,38.901286526,4928,29.4172334112,9369
GA,2020,2,20,24.11648756,4188,45.93862905,4537,35.4640011348,8725
GA,2020,2,21,25.65448495,3864,46.475609811,4444,36.7918319507,8308
GA,2020,2,22,21.73127539,3850,43.3443865827,5396,34.3447674942,9246
GA,2020,2,23,30.89822955,3886,41.0723353151,4205,36.1858472415,8091
GA,2020,2,24,20.42896032,4213,45.6378489805,4463,33.3966032536,8676
GA,2020,2,25,18.5909928,4311,37.9112703863,4660,28.6269412508,8971
GA,2020,2,26,22.38033706,4361,44.0253861299,4571,33.457309664,8932
GA,2020,2,27,26.94967443,4361,45.4224736502,4649,36.4813107868,9010
GA,2020,2,28,29.71994534,4211,45.4826249209,4743,38.0695532529,8954
GA,2020,2,29,28.63491431,3968,43.7091535698,4454,36.6069710261,8422
GA,2020,3,1,27.83530201,3891,56.6094717624,4108,42.6126853508,7999
GA,2020,3,2,21.03065587,4254,43.0934279279,4440,32.2980480873,8694
GA,2020,3,3,17.94549272,4222,41.6024994371,4441,30.0730197696,8663
GA,2020,3,4,18.27645004,4262,38.4105961879,4512,28.6303670014,8774
GA,2020,3,5,22.34002827,4249,42.3282049074,4646,32.7801708959,8895
GA,2020,3,6,25.55519973,4004,45.166929186,4533,35.9686903735,8537
GA,2020,3,7,24.88382426,3802,41.3940822931,4326,33.6711490941,8128
GA,2020,3,8,30.20609076,3686,40.2659919537,3977,35.427052139,7663
GA,2020,3,9,22.36971434,3990,42.2231321023,4224,32.5792147817,8214
GA,2020,3,10,19.87776294,4193,41.0645310016,4403,30.7299429976,8596
GA,2020,3,11,21.18641289,4558,45.5522146543,4845,33.7411623899,9403
GA,2020,3,12,23.19726435,4668,43.7685766423,5206,34.0433502112,9874
GA,2020,3,13,27.82128606,4129,45.9596594617,4904,37.668577454,9033
GA,2020,3,14,24.26029759,3965,38.9115475908,4213,31.8080740944,8178
GA,2020,3,15,27.42045308,4017,40.0071288286,4277,33.9110742733,8294
GA,2020,3,16,19.58667636,4477,36.3609040274,4668,28.1489611879,9145
GA,2020,3,17,16.00884999,4539,32.7863393041,4857,24.6815049068,9396
GA,2020,3,18,13.71870738,4456,36.2460143354,4604,25.1663587291,9060
GA,2020,3,19,12.18852934,4481,32.327652459,4575,22.3626115252,9056
GA,2020,3,20,14.3572636,4283,32.6318737103,4846,24.0580808411,9129
GA,2020,3,21,12.74139986,4029,31.6778436406,4285,22.5011618999,8314
GA,2020,3,22,12.60568331,3871,27.4391827637,4038,20.1790390812,7909
GA,2020,3,23,9.360915018,4142,26.8800785401,4329,18.3138673125,8471
GA,2020,3,24,8.97721951,4305,26.5473421111,4481,17.9382620067,8786
GA,2020,3,25,9.903973373,4359,28.7647215333,4435,19.4158471609,8794
GA,2020,3,26,8.04558579,4336,29.2812412281,4560,18.9307688833,8896
GA,2020,3,27,7.955834398,3973,29.4208071349,4485,19.3380054461,8458
GA,2020,3,28,8.244272697,3843,29.1832077735,4168,19.1384783391,8011
GA,2020,3,29,9.770944265,3823,28.643015873,4032,19.4580470942,7855
GA,2020,3,30,7.565495253,3998,25.5191349563,4231,16.796489248,8229
GA,2020,3,31,9.338319172,4129,27.743390444,4144,18.5575401742,8273
GA,2020,4,1,9.425485894,4229,27.9641592129,4472,18.9536949599,8701
GA,2020,4,2,7.504139539,4114,24.3204473806,4314,16.111822504,8428
GA,2020,4,3,6.745824168,3913,26.2352389834,4289,16.9372531053,8202
GA,2020,4,4,6.93914671,3797,21.4101615754,3961,14.3276089273,7758
GA,2020,4,5,6.108896842,3798,23.4218510911,3895,14.8745223198,7693
GA,2020,4,6,7.770532786,3923,22.7295263804,4075,15.3921755588,7998
GA,2020,4,7,7.620026954,4077,24.2362916667,4080,15.9312148941,8157
GA,2020,4,8,7.179539939,3717,23.7185009311,4296,16.0465530954,8013
GA,2020,4,9,7.989241947,3509,24.9071817926,3559,16.5080517816,7068
GA,2020,4,10,8.569100748,3614,27.7431700436,3899,18.519812339,7513
GA,2020,4,11,7.015491573,3489,24.363693072,3623,15.8530244795,7112
GA,2020,4,12,6.945457176,3456,22.5781306865,3627,14.9504983764,7083
GA,2020,4,13,7.293352813,3761,25.2183213737,3902,16.4207477397,7663
GA,2020,4,14,8.147050651,3733,24.4871067416,3916,16.5125441339,7649
GA,2020,4,15,8.077814544,3688,25.0105073777,3863,16.7403747899,7551
GA,2020,4,16,7.874961273,3741,27.5677941176,3808,17.8087680649,7549
GA,2020,4,17,9.289383182,3421,26.1422127329,3864,18.2282072568,7285
GA,2020,4,18,8.11117228,3395,27.2463426053,3631,18.0001280801,7026
GA,2020,4,19,6.783360306,3458,21.1191455161,3546,14.0413120985,7004
GA,2020,4,20,7.870954299,3741,25.7277897713,3891,16.9748519435,7632
GA,2020,4,21,7.394995885,3651,23.9553186405,3766,15.8035405118,7417
GA,2020,4,22,7.925218649,3819,24.9134091503,3825,16.4259811644,7644
GA,2020,4,23,7.055020876,3830,24.7791986149,4043,16.1568690404,7873
GA,2020,4,24,7.23347636,3472,24.0530192452,4001,16.2385601394,7473
GA,2020,4,25,8.834107774,3228,31.1786801328,3614,20.6366924722,6842
GA,2020,4,26,8.397846918,3214,24.6808991745,3392,16.7587481069,6606
GA,2020,4,27,8.835460325,3335,27.5560922467,3534,18.4669515481,6869
GA,2020,4,28,8.293297503,3442,26.3359747899,3570,17.47931546,7012
GA,2020,4,29,7.134579854,3487,28.3543904426,3683,18.0345188216,7170
GA,2020,4,30,11.83913236,3596,26.8592361673,3705,19.4613052961,7301
GA,2020,5,1,10.37667448,3401,34.4846530714,4021,23.4375990173,7422
GA,2020,5,2,8.565313773,3235,28.2222767857,3584,18.8968221228,6819
GA,2020,5,3,9.261500814,3225,28.9835596171,3447,19.4506400068,6672
GA,2020,5,4,7.873840462,3523,29.6851455503,3607,18.9079747472,7130
GA,2020,5,5,9.792325369,3479,29.0902085533,3788,19.8515494645,7267
GA,2020,5,6,10.21222766,3470,30.9210448164,3704,20.904374126,7174
GA,2020,5,7,14.45570056,3533,30.9716253298,3790,23.0034753623,7323
GA,2020,5,8,14.00705597,3305,34.137301877,3836,24.8206147572,7141
GA,2020,5,9,14.31570759,3180,34.6306882353,3400,24.8128100511,6580
GA,2020,5,10,13.79769132,3123,35.8004916594,3417,25.2936498459,6540
GA,2020,5,11,11.02884257,3283,30.9848595338,3346,21.10167901,6629
GA,2020,5,12,9.521177332,3423,30.5438275007,3629,20.3395547373,7052
GA,2020,5,13,9.037491332,3173,30.5385045694,3611,20.4820902117,6784
GA,2020,5,14,11.5810957,3240,27.8156069008,3246,19.705860325,6486
GA,2020,5,15,11.41109771,3316,34.4257817337,3876,23.8144507795,7192
GA,2020,5,16,12.0384522,3198,31.8661401021,3526,22.435898295,6724
GA,2020,5,17,14.05459348,3198,35.8752603129,3515,25.480132571,6713
GA,2020,5,18,11.51966459,3458,33.0737650933,3644,22.5789636936,7102
GA,2020,5,19,11.95596642,3513,29.1374183813,3645,20.7051131648,7158
GA,2020,5,20,11.25200872,3445,32.9045132275,3780,22.580239452,7225
GA,2020,5,21,13.83253767,3452,33.8643274696,3695,24.1889757992,7147
GA,2020,5,22,17.20930877,3284,36.2256080904,3807,27.4187364266,7091
GA,2020,5,23,14.71905342,3106,36.7583557335,3497,26.3912388191,6603
GA,2020,5,24,15.68069753,3154,33.5922770839,3443,25.0288206775,6597
GA,2020,5,25,16.41975474,3262,35.4725717599,3449,26.2116137628,6711
GA,2020,5,26,13.03068277,3442,35.9950750268,3732,24.9770323522,7174
GA,2020,5,27,12.77857391,3450,31.6446769397,3699,22.5401790446,7149
GA,2020,5,28,15.68644562,3725,34.9392564767,3860,25.4841845662,7585
GA,2020,5,29,16.04649121,3876,38.1969617978,4450,27.8852606209,8326
GA,2020,5,30,13.36856232,3603,41.2701614391,4336,28.6074253733,7939
GA,2020,5,31,21.0965777,3521,33.2199716568,3881,27.4530883655,7402
GA,2020,6,1,12.91638584,3644,42.1919115088,4023,28.2777318379,7667
GA,2020,6,2,10.5908915,3612,32.8074821385,4059,22.3464828703,7671
GA,2020,6,3,12.38128411,3559,31.1446134538,3984,22.2915458236,7543
GA,2020,6,4,14.80983712,3500,32.7999032427,3824,24.2027935445,7324
GA,2020,6,5,16.02191384,3344,36.0927582645,3872,26.7916352385,7216
GA,2020,6,6,12.32074856,3166,33.4807603166,3538,23.4878311368,6704
GA,2020,6,7,17.79483417,3045,33.4011433447,3516,26.1581603487,6561
GA,2020,6,8,12.25590376,3325,36.7927820665,3368,24.6031630064,6693
GA,2020,6,9,10.30518169,3468,35.4403434445,3989,23.750824742,7457
GA,2020,6,10,13.63795811,3389,34.4582749103,3623,24.3955176889,7012
GA,2020,6,11,18.28036003,3361,40.4724579946,3690,29.8941511929,7051
GA,2020,6,12,18.90566517,3255,40.4377995043,3631,30.2595977532,6886
GA,2020,6,13,16.64449014,3285,36.7678211072,3667,27.2590261953,6952
GA,2020,6,14,19.20183327,3251,42.4863313609,3718,31.6242416359,6969
GA,2020,6,15,17.48219398,3309,40.2813550362,3594,29.3524221179,6903
GA,2020,6,16,12.93308143,3401,34.5588032062,3618,24.0802336435,7019
GA,2020,6,17,15.65338104,3493,35.0086490807,3753,25.6782666261,7246
GA,2020,6,18,21.11393795,3545,38.7952256342,3745,30.1971234613,7290
GA,2020,6,19,21.04525478,3317,40.3144278735,3889,31.4446183882,7206
GA,2020,6,20,18.10732879,3227,39.3483342634,3584,29.2845074153,6811
GA,2020,6,21,24.68106076,3196,40.7694014891,3492,33.0812530187,6688
GA,2020,6,22,17.44762006,3395,41.5119579832,3570,29.7821048247,6965
GA,2020,6,23,14.61749702,3384,39.5240900563,3731,27.6781433472,7115
GA,2020,6,24,15.26163641,3300,38.4603977433,3545,27.2761884811,6845
GA,2020,6,25,17.99948474,3338,37.2865488977,3538,27.9235151341,6876
GA,2020,6,26,21.0440412,3207,40.8671598123,3623,31.5592913804,6830
GA,2020,6,27,19.01937711,3275,39.4970971429,3500,29.5982730679,6775
GA,2020,6,28,20.64697458,3345,43.5023698937,3574,32.4528978133,6919
GA,2020,6,29,15.86345385,3402,40.3434084507,3550,28.3640060411,6952
GA,2020,6,30,15.00636221,3164,35.4972006606,3633,25.9587259133,6797
GA,2020,7,1,21.70909375,3288,45.6017020697,3672,34.3145043463,6960
GA,2020,7,2,22.06061583,3264,40.6118320399,3608,31.8005442475,6872
GA,2020,7,3,20.65530183,3346,47.7437678322,3575,34.6476824047,6921
GA,2020,7,4,19.58367395,3239,37.8308514639,3723,29.3415369038,6962
GA,2020,7,5,27.64827813,3200,44.596395881,3496,36.4969369797,6696
GA,2020,7,6,21.95228781,3405,43.9895222759,3726,33.4669050614,7131
GA,2020,7,7,17.05521409,3410,40.7220877585,3578,29.1731411057,6988
GA,2020,7,8,15.6214737,3420,41.1943507185,3758,29.010004187,7178
GA,2020,7,9,17.26821014,3436,40.1517344465,3713,29.1533025655,7149
GA,2020,7,10,17.25488365,3309,40.4912672689,3764,29.620463735,7073
GA,2020,7,11,17.45008048,3232,37.705372473,3611,28.1386468086,6843
GA,2020,7,12,21.60832302,3232,39.1202376957,3576,30.8067082845,6808
GA,2020,7,13,18.35911775,3412,45.9553193803,3679,32.6767634696,7091
GA,2020,7,14,16.80020709,3429,38.0626136986,3650,27.76330698,7079
GA,2020,7,15,15.03175719,3443,38.4804770839,3731,27.2267911911,7174
GA,2020,7,16,18.63811366,3536,35.9048544203,3778,27.5571383513,7314
GA,2020,7,17,19.10275251,3455,41.1798614319,3897,30.8049415019,7352
GA,2020,7,18,17.9246784,3296,37.8231535724,3653,28.3850510874,6949
GA,2020,7,19,22.90159316,3264,40.4720826259,3534,32.0357664128,6798
GA,2020,7,20,17.37597084,3358,43.0498731786,3706,30.8453199435,7064
GA,2020,7,21,15.7825998,3381,37.1769055287,3726,26.9990319296,7107
GA,2020,7,22,16.28699278,3465,37.0512304429,3771,27.1081564376,7236
GA,2020,7,23,16.61399073,3468,40.0133705179,3765,28.7940909514,7233
GA,2020,7,24,20.08139772,3291,42.5463558442,3850,32.1931592069,7141
GA,2020,7,25,19.53487982,3203,38.6267151826,3504,29.5092038264,6707
GA,2020,7,26,20.38188212,3172,39.1638943991,3428,30.1371454674,6600
GA,2020,7,27,14.55341944,3328,40.8635841199,3602,28.2286305767,6930
GA,2020,7,28,13.18879887,3405,38.8328948817,3634,26.4279869516,7039
GA,2020,7,29,17.18280151,3491,40.707456427,3672,29.2423481881,7163
GA,2020,7,30,21.63708279,3421,37.0018755009,3743,29.6647794842,7164
GA,2020,7,31,19.12138775,3178,43.796,3735,32.4527455908,6913
IA,2020,1,1,28.21178177,825,25.7957869822,845,26.9893173415,1670
IA,2020,1,2,21.01879322,812,23.400982906,702,22.1233488076,1514
IA,2020,1,3,17.02986753,830,26.5454464286,784,21.6520570322,1614
IA,2020,1,4,16.04585591,888,23.3869642857,896,19.7328699821,1784
IA,2020,1,5,18.35745548,841,25.5622604952,929,22.1389604851,1770
IA,2020,1,6,15.24571435,812,18.8689487179,780,17.0209171182,1592
IA,2020,1,7,12.70146465,833,18.4091172914,827,15.5449759358,1660
IA,2020,1,8,12.6330351,827,21.8583928571,784,17.1225946789,1611
IA,2020,1,9,16.4510391,895,25.1938231917,871,20.7630237794,1766
IA,2020,1,10,19.04850388,909,22.8062720665,963,20.9815865528,1872
IA,2020,1,11,15.3709968,943,20.9256480506,949,18.1571300118,1892
IA,2020,1,12,17.13927505,938,21.2585462098,963,19.2259968421,1901
IA,2020,1,13,13.28201372,1023,19.1184199584,962,16.1105390607,1985
IA,2020,1,14,9.983608985,762,18.9424590164,1037,15.1477710098,1799
IA,2020,1,15,16.03699701,686,24.6563511188,581,19.9895185074,1267
IA,2020,1,16,12.64593305,927,19.9464908257,872,16.1846136394,1799
IA,2020,1,17,11.98639776,930,11.5722507708,973,11.7746452532,1903
IA,2020,1,18,16.62284816,955,17.4632615716,929,17.0372558348,1884
IA,2020,1,19,19.12628366,888,25.4626789168,1034,22.5351456244,1922
IA,2020,1,20,19.54600234,858,22.2663431953,845,20.8957897873,1703
IA,2020,1,21,13.85268182,921,18.0420862471,858,15.8732040226,1779
IA,2020,1,22,16.98641414,937,16.6418398268,924,16.8153304939,1861
IA,2020,1,23,17.27071121,928,19.6324210526,855,18.4032192949,1783
IA,2020,1,24,22.10181915,951,21.3712070875,903,21.7459708801,1854
IA,2020,1,25,17.68759182,926,20.4820348205,919,19.0795122088,1845
IA,2020,1,26,18.21219645,947,25.501420508,1063,22.0671442976,2010
IA,2020,1,27,16.22599996,915,20.8240362812,882,18.4827990893,1797
IA,2020,1,28,14.61243216,958,24.1836305048,931,19.3296294385,1889
IA,2020,1,29,19.76458017,965,20.9659694989,918,20.3502813935,1883
IA,2020,1,30,20.81327815,1086,24.2939057592,955,22.4418912645,2041
IA,2020,1,31,25.15613369,1182,26.6951672535,1136,25.9103796469,2318
IA,2020,2,1,23.50864494,1358,43.0915853659,1230,32.8158384191,2588
IA,2020,2,2,16.0423479,954,34.3418876263,1584,27.4633372327,2538
IA,2020,2,3,34.95315728,757,18.7820266272,676,27.3246266999,1433
IA,2020,2,4,19.82374874,963,41.958697001,967,30.9141606407,1930
IA,2020,2,5,12.66379118,881,39.8162128476,1043,27.383113321,1924
IA,2020,2,6,17.84137334,415,20.2757613169,729,19.3926572868,1144
IA,2020,2,7,13.20215218,460,4.22187319885,347,9.34074349789,807
IA,2020,2,8,18.58067073,820,19.9889864865,888,19.3128629968,1708
IA,2020,2,9,21.01660902,752,14.5475800256,781,17.7209067078,1533
IA,2020,2,10,11.40745057,808,15.1153142857,700,13.1286074672,1508
IA,2020,2,11,10.77317689,746,21.4943719212,812,16.3608600513,1558
IA,2020,2,12,13.43595313,724,17.3688993711,636,15.2751838721,1360
IA,2020,2,13,14.99498299,879,15.145323741,834,15.0681786621,1713
IA,2020,2,14,22.18255813,817,22.4252570093,856,22.306736397,1673
IA,2020,2,15,13.93651999,750,18.9676413959,831,16.5809614121,1581
IA,2020,2,16,23.14611749,801,17.1269745649,747,20.2415310785,1548
IA,2020,2,17,11.42729453,791,13.7357391304,805,12.5916415872,1596
IA,2020,2,18,12.23465581,799,19.7677242303,747,15.8745019354,1546
IA,2020,2,19,14.13430411,855,25.9410224719,890,20.156068776,1745
IA,2020,2,20,18.44844171,815,20.0691564792,818,19.26028781,1633
IA,2020,2,21,16.33672619,785,28.7274869792,768,22.464288512,1553
IA,2020,2,22,18.6823566,785,20.0845692159,1033,19.4791033724,1818
IA,2020,2,23,15.79943832,730,18.8681118881,715,17.3178477326,1445
IA,2020,2,24,14.61996207,792,18.2280991736,726,16.3455928587,1518
IA,2020,2,25,13.43775238,832,23.6379214195,789,18.4025477978,1621
IA,2020,2,26,18.04542391,861,20.4548628429,802,19.2074022769,1663
IA,2020,2,27,15.66265325,848,22.594261658,772,18.9658641704,1620
IA,2020,2,28,17.42589336,845,23.4911084337,830,20.4313432174,1675
IA,2020,2,29,26.25450354,826,20.5772451456,824,23.4193151055,1650
IA,2020,3,1,21.30318705,775,21.5904884668,737,21.4432274893,1512
IA,2020,3,2,16.34234519,840,22.0332401525,787,19.0951013888,1627
IA,2020,3,3,15.8348488,893,16.1315537383,856,15.9800628807,1749
IA,2020,3,4,18.16435796,849,25.8888471178,798,21.907006623,1647
IA,2020,3,5,15.39798577,844,26.3536431227,807,20.7530526892,1651
IA,2020,3,6,20.91557106,788,29.3894655582,842,25.2928834327,1630
IA,2020,3,7,19.86055338,741,27.3773360107,747,23.634099499,1488
IA,2020,3,8,19.41142081,746,23.4840131579,760,21.4666466961,1506
IA,2020,3,9,15.25656633,798,19.5051971831,710,17.2569164001,1508
IA,2020,3,10,14.94488838,896,21.9184109916,837,18.312942867,1733
IA,2020,3,11,16.54431992,1044,20.6163915344,945,18.4790145784,1989
IA,2020,3,12,21.07853148,1001,22.3877875244,1026,21.7412333554,2027
IA,2020,3,13,17.86885888,850,24.5386388584,911,21.3192674889,1761
IA,2020,3,14,18.1437775,773,16.9806233062,738,17.5756717455,1511
IA,2020,3,15,16.18815376,845,13.8178645833,768,15.0595845798,1613
IA,2020,3,16,11.54479451,949,16.5605645161,868,13.9408805669,1817
IA,2020,3,17,7.643657044,968,18.0363006397,938,12.7581899363,1906
IA,2020,3,18,9.455217792,964,16.7923604651,860,12.9146162015,1824
IA,2020,3,19,10.10627881,954,10.4831659389,916,10.29089304,1870
IA,2020,3,20,9.3196092,947,13.8155372807,912,11.5252500874,1859
IA,2020,3,21,7.122466353,892,10.156978022,910,8.65487790615,1802
IA,2020,3,22,9.042769091,874,9.52875603865,828,9.27919517364,1702
IA,2020,3,23,4.266185688,894,10.6573608018,898,7.46890625283,1792
IA,2020,3,24,3.971025372,907,11.7822591743,872,7.79980326723,1779
IA,2020,3,25,6.251574056,953,17.9103959276,884,11.8620250819,1837
IA,2020,3,26,7.063836593,967,15.722112069,928,11.3038786203,1895
IA,2020,3,27,7.865250542,878,11.2451138952,878,9.55518221861,1756
IA,2020,3,28,4.771830682,874,11.3019110577,832,7.95648887226,1706
IA,2020,3,29,7.253814733,831,8.87278436019,844,8.0695821153,1675
IA,2020,3,30,4.091963933,886,11.4770666667,825,7.65286969295,1711
IA,2020,3,31,5.996206108,912,7.98077636153,863,6.96109857493,1775
IA,2020,4,1,8.540468474,918,11.801842723,852,10.1103503159,1770
IA,2020,4,2,7.467415173,913,10.7111904762,840,9.02176272273,1753
IA,2020,4,3,6.339376496,850,15.4750234192,854,10.9179225479,1704
IA,2020,4,4,5.323599006,803,10.7625982256,789,8.01918341823,1592
IA,2020,4,5,3.321100014,800,16.0310953608,776,9.5793210731,1576
IA,2020,4,6,4.980884629,893,11.7970126582,790,8.18037431592,1683
IA,2020,4,7,4.447410793,896,12.4994367816,870,8.41415066281,1766
IA,2020,4,8,3.261622291,789,13.4668613975,873,8.62213597328,1662
IA,2020,4,9,3.782427808,762,14.3971240876,685,8.80735313732,1447
IA,2020,4,10,3.975136998,730,13.6124704336,761,8.89399061606,1491
IA,2020,4,11,4.176500019,720,10.2525622255,683,7.13441198409,1403
IA,2020,4,12,3.585187707,719,8.05667136812,709,5.80527308217,1428
IA,2020,4,13,4.686253188,790,9.99648648649,740,7.25460131929,1530
IA,2020,4,14,7.015423159,839,10.5899076517,758,8.71201629956,1597
IA,2020,4,15,6.779402756,854,10.3711372064,809,8.52667465642,1663
IA,2020,4,16,4.778316726,903,13.4774278846,832,8.9498789646,1735
IA,2020,4,17,4.146160708,784,13.1813612004,933,9.05579498839,1717
IA,2020,4,18,6.615497874,713,14.2431934033,667,10.3022173798,1380
IA,2020,4,19,5.237180542,720,17.9021793103,725,11.5915916887,1445
IA,2020,4,20,6.213913074,736,10.7458139535,688,8.40348316184,1424
IA,2020,4,21,4.881443488,762,8.86914864865,740,6.84609183612,1502
IA,2020,4,22,4.53919335,843,12.8470741222,769,8.50244416504,1612
IA,2020,4,23,6.740635886,865,11.7272196796,874,9.24683153616,1739
IA,2020,4,24,5.238784144,732,14.9195470799,839,10.408841498,1571
IA,2020,4,25,2.92197932,677,18.7178192253,697,10.9348617174,1374
IA,2020,4,26,4.385201209,671,14.6768338558,638,9.40129107047,1309
IA,2020,4,27,4.415383503,704,7.40606774669,679,5.88369485619,1383
IA,2020,4,28,5.373964083,724,8.3981884058,690,6.8497171118,1414
IA,2020,4,29,5.62013603,735,9.71709770115,696,7.61278824741,1431
IA,2020,4,30,8.232139092,748,11.3959513591,699,9.76047687686,1447
IA,2020,5,1,12.3253178,692,17.3964179104,737,14.9407137282,1429
IA,2020,5,2,7.403970276,607,14.8762183544,632,11.2154801917,1239
IA,2020,5,3,5.227312044,625,14.7775215146,581,9.82820068615,1206
IA,2020,5,4,5.827975837,662,17.2178881988,644,11.4444410445,1306
IA,2020,5,5,3.289581013,716,9.78081602374,674,6.43712950022,1390
IA,2020,5,6,4.931183965,701,9.94229230769,650,7.34215393003,1351
IA,2020,5,7,8.993564428,721,14.2748316252,683,11.5627278865,1404
IA,2020,5,8,8.879906951,645,14.1301385042,722,11.652889527,1367
IA,2020,5,9,7.574510786,603,20.4447603834,626,14.1300650968,1229
IA,2020,5,10,11.35636972,606,18.3490499195,621,14.8954523637,1227
IA,2020,5,11,4.975466811,664,10.7897809077,639,7.82684571182,1303
IA,2020,5,12,5.493663284,677,11.768351145,655,8.57918922167,1332
IA,2020,5,13,3.425836056,610,14.1853692308,650,8.97638888425,1260
IA,2020,5,14,4.373182585,597,10.3898217469,561,7.28797927741,1158
IA,2020,5,15,6.945260562,614,17.8798918083,647,12.5556542308,1261
IA,2020,5,16,6.721824462,581,15.5648943089,615,11.2690551943,1196
IA,2020,5,17,7.207048028,603,10.1363422819,596,8.66314425428,1199
IA,2020,5,18,6.82388462,659,10.7863664596,644,8.78231770114,1303
IA,2020,5,19,7.945671375,700,13.1176811594,621,10.3770249527,1321
IA,2020,5,20,5.956575105,692,11.4113636364,682,8.66411933964,1374
IA,2020,5,21,10.54160901,665,17.6863455657,654,14.0841849823,1319
IA,2020,5,22,10.45577164,622,20.2955442671,689,15.6270937911,1311
IA,2020,5,23,9.695197321,583,17.8515495495,555,13.673031668,1138
IA,2020,5,24,10.48311772,603,16.3023104693,554,13.2694900477,1157
IA,2020,5,25,13.46806991,601,18.136130137,584,15.7686160472,1185
IA,2020,5,26,6.789842514,635,15.5850874404,629,11.166590187,1264
IA,2020,5,27,7.428144313,679,11.5707523511,638,9.43496582272,1317
IA,2020,5,28,10.28192354,733,17.2495726496,702,13.6904877734,1435
IA,2020,5,29,15.49814994,654,16.0913180516,698,15.8043861396,1352
IA,2020,5,30,6.773814976,616,18.2720489297,654,12.6949527758,1270
IA,2020,5,31,11.50818319,644,16.9980337942,651,14.2679459261,1295
IA,2020,6,1,7.622493187,730,17.707745098,714,12.6092451707,1444
IA,2020,6,2,4.944481381,723,10.9625462304,703,7.91131138742,1426
IA,2020,6,3,5.710772606,686,18.5894378698,676,12.1028267311,1362
IA,2020,6,4,5.619731763,671,11.2643140028,707,8.5157547264,1378
IA,2020,6,5,10.51302835,601,18.0361075949,632,14.3691403393,1233
IA,2020,6,6,10.25212907,573,19.4402268761,573,14.846177973,1146
IA,2020,6,7,7.220293043,546,12.2860394265,558,9.78069746511,1104
IA,2020,6,8,8.518496556,572,14.3076296296,540,11.3297662141,1112
IA,2020,6,9,9.501858477,608,15.3008950086,581,12.3355340236,1189
IA,2020,6,10,9.226340325,664,17.3883792049,654,13.2763960363,1318
IA,2020,6,11,12.74968204,629,17.6151687117,652,15.2261046082,1281
IA,2020,6,12,11.61987631,566,23.3347166922,653,17.895340436,1219
IA,2020,6,13,13.55642454,523,15.2742337165,522,14.41450721,1045
IA,2020,6,14,13.73788147,557,21.2501188455,589,17.598883053,1146
IA,2020,6,15,8.529671774,579,14.7153456998,593,11.6594538883,1172
IA,2020,6,16,9.26382127,649,11.158778135,622,10.1911723086,1271
IA,2020,6,17,11.12487258,667,15.0911525974,616,13.0291816141,1283
IA,2020,6,18,11.45264335,628,16.4910815047,638,13.9917614722,1266
IA,2020,6,19,14.52556976,623,19.6550847458,649,17.1427515413,1272
IA,2020,6,20,14.91639729,594,19.6245614035,627,17.3341031861,1221
IA,2020,6,21,11.61809278,582,17.9496126761,568,14.7453130417,1150
IA,2020,6,22,9.675032038,624,19.2889776358,626,14.4896959934,1250
IA,2020,6,23,12.74616271,615,15.2362460568,634,14.0101441687,1249
IA,2020,6,24,7.370470246,638,18.1713082437,558,12.4096572048,1196
IA,2020,6,25,13.03721581,607,14.440515625,640,13.7574338385,1247
IA,2020,6,26,13.31739128,598,20.246748366,612,16.8221570128,1210
IA,2020,6,27,15.09051416,564,18.1795509499,579,16.6553018252,1143
IA,2020,6,28,15.38959662,595,22.8882060391,563,19.0352936001,1158
IA,2020,6,29,8.471516504,666,17.2923824451,638,12.7872469261,1304
IA,2020,6,30,11.13754736,632,15.9605596465,679,13.6355071941,1311
IA,2020,7,1,17.41188071,654,28.031634757,679,22.821342824,1333
IA,2020,7,2,13.61264564,635,20.8323607038,682,17.3513287634,1317
IA,2020,7,3,10.00186231,639,20.0984292379,643,15.0658970484,1282
IA,2020,7,4,12.81185922,597,22.0980248834,643,17.627185447,1240
IA,2020,7,5,16.01897167,564,32.9123247232,542,24.2976311229,1106
IA,2020,7,6,13.87515865,599,19.0865533981,618,16.5215365911,1217
IA,2020,7,7,8.421981407,646,18.7584175084,594,13.373467733,1240
IA,2020,7,8,10.06911466,689,17.1854678363,684,13.6143335766,1373
IA,2020,7,9,9.761002861,698,19.6825864662,665,14.6016874519,1363
IA,2020,7,10,14.49494529,639,19.2578304598,696,16.9780674459,1335
IA,2020,7,11,10.27579468,604,19.0446036585,656,14.8411428466,1260
IA,2020,7,12,15.37003374,591,21.6642857143,602,18.5461776533,1193
IA,2020,7,13,10.00674247,660,14.7778938907,622,12.3216068878,1282
IA,2020,7,14,9.635476847,650,25.2881402439,656,17.4977641275,1306
IA,2020,7,15,6.632720325,647,20.5886291486,693,13.8502164554,1340
IA,2020,7,16,17.94828461,717,21.146966967,666,19.4886479142,1383
IA,2020,7,17,14.3440712,646,20.5376406036,729,17.6277890874,1375
IA,2020,7,18,14.95902524,595,26.1378178964,637,20.7389691703,1232
IA,2020,7,19,23.08616787,595,20.0760839161,572,21.6107882456,1167
IA,2020,7,20,12.94699071,648,24.7876552795,644,18.8489937926,1292
IA,2020,7,21,8.040226951,661,19.5809345794,642,13.7264389982,1303
IA,2020,7,22,9.964971071,692,13.3689618321,655,11.6202152792,1347
IA,2020,7,23,11.3813685,760,19.307446505,701,15.1843669131,1461
IA,2020,7,24,12.98693947,660,15.0671967655,742,14.0879030315,1402
IA,2020,7,25,10.00745401,597,17.0956893819,631,13.6496987329,1228
IA,2020,7,26,16.79122512,604,23.5500692042,578,20.0963113134,1182
IA,2020,7,27,8.294455271,615,20.4215131579,608,14.3232788158,1223
IA,2020,7,28,7.934164249,682,21.8764353312,634,14.6510334482,1316
IA,2020,7,29,7.835654676,695,19.6570882353,680,13.681890909,1375
IA,2020,7,30,10.39416162,668,17.0251289398,698,13.7824597088,1366
IA,2020,7,31,18.18807224,581,25.7442054575,623,22.09793187,1204
ID,2020,1,1,32.40756737,333,48.1905449591,367,40.6823570489,700
ID,2020,1,2,25.83245214,314,40.1113548387,310,32.9261377756,624
ID,2020,1,3,30.93569767,344,41.2788650307,326,35.9683432813,670
ID,2020,1,4,24.25347434,331,53.7718421053,342,39.2538930261,673
ID,2020,1,5,18.2346077,293,32.6314153846,325,25.8057444273,618
ID,2020,1,6,16.43937674,321,34.0054109589,292,24.8068840678,613
ID,2020,1,7,18.43984297,319,26.5457763975,322,22.5117783267,641
ID,2020,1,8,17.63672728,330,22.7584,300,20.0756190514,630
ID,2020,1,9,30.89760329,338,39.5790697674,344,35.2765247977,682
ID,2020,1,10,17.5027909,301,34.3883987915,331,26.3463608559,632
ID,2020,1,11,28.88650019,320,39.5342810458,306,34.0913259757,626
ID,2020,1,12,26.71379532,361,40.5539053254,338,33.4061518033,699
ID,2020,1,13,27.64997263,367,37.9225825826,333,32.536799936,700
ID,2020,1,14,14.57716676,300,20.6558725762,361,17.8970045809,661
ID,2020,1,15,25.18111914,277,17.9137387387,222,21.9479358753,499
ID,2020,1,16,15.95371826,355,21.8809677419,310,18.7167969659,665
ID,2020,1,17,19.04250004,328,28.9710555556,360,24.2376744377,688
ID,2020,1,18,15.81046927,341,40.5988852459,305,27.5139783608,646
ID,2020,1,19,23.71388394,345,41.1469883041,342,32.3923725754,687
ID,2020,1,20,19.86659318,317,26.6668150685,292,23.1271264993,609
ID,2020,1,21,22.72206906,319,33.5217405063,316,28.0963937483,635
ID,2020,1,22,18.53916404,335,31.8731306991,329,25.1459035443,664
ID,2020,1,23,26.37475925,332,32.1278360656,305,29.129372168,637
ID,2020,1,24,18.94463943,319,35.6484761905,315,27.2438643189,634
ID,2020,1,25,14.09711536,312,33.9231468531,286,23.5791304219,598
ID,2020,1,26,32.24842908,312,38.8845321637,342,35.718684821,654
ID,2020,1,27,21.23226645,300,19.4845302013,298,20.3613209615,598
ID,2020,1,28,23.96024088,332,25.1697142857,315,24.5490880559,647
ID,2020,1,29,17.7582164,342,29.6135504886,307,23.3662095667,649
ID,2020,1,30,27.31994541,365,27.8864880952,336,27.5914979667,701
ID,2020,1,31,20.39408823,340,20.3435860058,343,20.3687262053,683
ID,2020,2,1,20.7897321,336,39.4276450512,293,29.4716215987,629
ID,2020,2,2,29.3550492,204,28.3801186944,337,28.7477449848,541
ID,2020,2,3,32.96730939,197,22.654516129,155,28.4261646302,352
ID,2020,2,4,14.6483976,312,26.8174297189,249,20.0496257597,561
ID,2020,2,5,24.51895356,344,40.9715662651,332,32.5992308057,676
ID,2020,2,6,14.40207552,159,39.3130604982,281,30.3111363811,440
ID,2020,2,7,16.18871641,187,15.7319685039,127,16.0039807919,314
ID,2020,2,8,20.44579092,297,27.2447741935,310,23.9180888027,607
ID,2020,2,9,26.63866682,285,38.1011073826,298,32.497684466,583
ID,2020,2,10,23.04789659,309,31.6019272727,275,27.0759076135,584
ID,2020,2,11,18.42959991,300,33.5350949367,316,26.1785226834,616
ID,2020,2,12,18.45650339,306,42.4485546875,256,29.3852669704,562
ID,2020,2,13,38.62399411,353,36.3653488372,301,37.5844647107,654
ID,2020,2,14,24.60342036,307,35.9255722892,332,30.4859781698,639
ID,2020,2,15,27.56685939,277,34.8960750853,293,31.3343334229,570
ID,2020,2,16,38.70692618,270,22.8712318841,276,30.7020697227,546
ID,2020,2,17,29.14368757,301,43.510443686,293,36.2303197956,594
ID,2020,2,18,15.4024472,331,27.3421071429,280,20.8739771247,611
ID,2020,2,19,22.78370678,348,26.7775074184,337,24.7485400868,685
ID,2020,2,20,25.64237826,349,25.3869275362,345,25.5153890673,694
ID,2020,2,21,37.90936924,317,40.0420779221,308,38.9603680785,625
ID,2020,2,22,21.80878988,314,36.6436266667,375,29.88290279,689
ID,2020,2,23,34.11727547,323,40.1415824916,297,37.0031128658,620
ID,2020,2,24,18.90881995,339,42.5414827586,290,29.8046422306,629
ID,2020,2,25,30.33776809,345,27.847165109,321,29.1373423289,666
ID,2020,2,26,33.26644109,354,36.00696875,320,34.5675818188,674
ID,2020,2,27,32.36630579,360,42.8606552707,351,37.5470605969,711
ID,2020,2,28,29.99644402,329,46.3377846154,325,38.1171407991,654
ID,2020,2,29,31.31305769,278,47.5735738832,291,39.6290686078,569
ID,2020,3,1,48.13113982,272,62.0593700787,254,54.8569392225,526
ID,2020,3,2,19.44806572,305,31.1878476821,302,25.2889457077,607
ID,2020,3,3,23.10945621,331,54.4572280702,285,37.6128896193,616
ID,2020,3,4,27.09789925,338,30.9628267477,329,29.0042877759,667
ID,2020,3,5,29.37313624,338,29.4300903614,332,29.4013582823,670
ID,2020,3,6,26.93821312,319,31.2300909091,330,29.1205238602,649
ID,2020,3,7,35.60549471,293,37.0435766423,274,36.300440829,567
ID,2020,3,8,44.86820445,284,53.9811567164,268,49.2926088112,552
ID,2020,3,9,22.77266689,315,52.7646071429,280,36.8865211266,595
ID,2020,3,10,18.34846772,372,29.994925816,337,23.8842313002,709
ID,2020,3,11,22.18525346,434,34.3889556136,383,27.9062056324,817
ID,2020,3,12,26.29606044,429,46.8065853659,410,36.3190821559,839
ID,2020,3,13,19.46066088,348,33.0723453608,388,26.6363858509,736
ID,2020,3,14,27.20098455,325,29.6418506494,308,28.3886413566,633
ID,2020,3,15,23.532219,320,21.0420504732,317,22.2929985557,637
ID,2020,3,16,13.34248577,354,28.7892284866,337,20.875846545,691
ID,2020,3,17,10.3340821,365,39.8209142857,350,24.7681957573,715
ID,2020,3,18,14.55387276,377,22.9167435159,347,18.562044241,724
ID,2020,3,19,14.19664872,370,24.4249147727,352,19.183282585,722
ID,2020,3,20,10.99842423,330,25.338739726,365,18.5296690588,695
ID,2020,3,21,13.3462614,329,30.4479365079,315,21.7112111811,644
ID,2020,3,22,7.656336648,303,37.4464506173,324,23.0502711393,627
ID,2020,3,23,7.58778729,348,16.0872990354,311,11.5989377495,659
ID,2020,3,24,19.52772379,391,21.7062138728,346,20.5504613323,737
ID,2020,3,25,11.1023691,401,21.8288916877,397,16.4387468786,798
ID,2020,3,26,10.77834191,392,21.6951089588,413,16.3791180481,805
ID,2020,3,27,15.72440772,363,16.7511680912,351,16.2291596672,714
ID,2020,3,28,11.73659751,338,30.84759375,320,21.0306990249,658
ID,2020,3,29,7.055507669,325,33.2414939024,328,20.2086523621,653
ID,2020,3,30,14.883017,411,25.9218181818,330,19.7990823036,741
ID,2020,3,31,7.464426251,488,18.8604690432,533,13.4135847311,1021
ID,2020,4,1,7.872512881,390,22.692025974,385,15.2344645466,775
ID,2020,4,2,7.331971844,355,18.2227297297,370,12.8900137995,725
ID,2020,4,3,3.688278955,337,24.2819642857,336,13.9698217055,673
ID,2020,4,4,6.731280454,328,26.8883742331,326,16.7790060993,654
ID,2020,4,5,1.726129033,341,19.795304878,328,10.5851569511,669
ID,2020,4,6,4.661933778,362,11.0916049383,324,7.69868808693,686
ID,2020,4,7,10.18347141,386,27.0352631579,342,18.100109841,728
ID,2020,4,8,10.55274516,357,35.7157300275,363,23.2390833641,720
ID,2020,4,9,13.88545167,321,16.3039144737,304,15.0617919777,625
ID,2020,4,10,11.45301887,318,28.4923148148,324,20.0522897207,642
ID,2020,4,11,6.623986729,301,32.257012987,308,19.5878161009,609
ID,2020,4,12,7.725939643,298,23.9906551724,290,15.7476530844,588
ID,2020,4,13,15.70050982,314,25.2442345277,307,20.4185830652,621
ID,2020,4,14,10.47396454,338,17.8724223602,322,14.0835151735,660
ID,2020,4,15,5.887259489,343,31.8011730205,341,18.8063304163,684
ID,2020,4,16,11.87424142,323,33.7154248366,306,22.499682001,629
ID,2020,4,17,13.83269358,297,36.1215662651,332,25.5972495918,629
ID,2020,4,18,9.231519416,283,36.5878125,288,23.0294395705,571
ID,2020,4,19,12.76554834,301,22.5212063492,315,17.7542370947,616
ID,2020,4,20,18.61490212,306,24.7663028169,284,21.5759153368,590
ID,2020,4,21,11.94186491,311,26.8055087719,285,19.049479844,596
ID,2020,4,22,7.200843722,320,17.5974454829,321,12.4072542762,641
ID,2020,4,23,11.29740527,343,27.4809567901,324,19.1586806711,667
ID,2020,4,24,4.845777113,296,41.3683006536,306,23.4103821021,602
ID,2020,4,25,8.91270168,285,33.0718150685,292,21.1388041227,577
ID,2020,4,26,5.541509477,265,26.6592727273,275,16.295925947,540
ID,2020,4,27,4.279166608,264,37.09692607,257,20.4675815442,521
ID,2020,4,28,7.669785733,280,25.9664285714,280,16.8181071522,560
ID,2020,4,29,3.963720117,293,30.7759352518,278,17.0176532299,571
ID,2020,4,30,11.78010127,296,35.1971865443,327,24.0712519678,623
ID,2020,5,1,21.67267375,288,23.3560509554,314,22.5507143522,602
ID,2020,5,2,15.48366934,248,23.059028777,278,19.4873764189,526
ID,2020,5,3,14.03103584,251,42.1773251029,243,27.8762752952,494
ID,2020,5,4,15.18278584,280,29.0150757576,264,21.8955147706,544
ID,2020,5,5,10.17328706,289,30.0696750903,277,19.910565301,566
ID,2020,5,6,9.289072087,291,32.2976408451,284,20.6533043084,575
ID,2020,5,7,10.93111518,269,31.5282332155,283,21.4908695352,552
ID,2020,5,8,12.46662765,255,23.5994814815,270,18.1920953348,525
ID,2020,5,9,20.97887271,275,42.1178225806,248,31.0026959756,523
ID,2020,5,10,20.75142862,245,32.9962605042,238,26.7851138963,483
ID,2020,5,11,17.53241251,257,31.1649003984,251,24.268149636,508
ID,2020,5,12,15.73698546,272,31.7087777778,270,23.6934133674,542
ID,2020,5,13,15.23407579,238,26.1712781955,266,21.0064881707,504
ID,2020,5,14,13.00909817,255,25.0012962963,216,18.508704954,471
ID,2020,5,15,11.81552241,268,25.4940892193,269,18.6675419104,537
ID,2020,5,16,13.20340016,250,36.5811313869,274,25.4276336641,524
ID,2020,5,17,12.68612492,240,36.1167901235,243,24.4742235627,483
ID,2020,5,18,16.41713781,290,30.5160820896,268,23.1886737722,558
ID,2020,5,19,8.60964657,283,31.0745878136,279,19.7621707817,562
ID,2020,5,20,14.62262766,274,15.1085769231,260,14.8592321701,534
ID,2020,5,21,18.69974115,309,40.0582130584,291,29.0586000256,600
ID,2020,5,22,23.79902267,266,25.2902758621,290,24.5768345867,556
ID,2020,5,23,19.58697404,228,42.1605241935,248,31.3479833637,476
ID,2020,5,24,18.72012725,236,26.12625,232,22.3915385278,468
ID,2020,5,25,13.47310757,251,42.7495744681,235,27.6294238685,486
ID,2020,5,26,12.88827306,249,25.7894047619,252,19.3774650538,501
ID,2020,5,27,10.64000001,261,31.0347985348,273,21.066554312,534
ID,2020,5,28,16.30543856,285,23.3853684211,285,19.8454034905,570
ID,2020,5,29,17.12466922,257,41.6819202899,276,29.8409943519,533
ID,2020,5,30,13.31793771,257,29.2931182796,279,21.6333768498,536
ID,2020,5,31,23.0514399,257,32.3957142857,280,27.923687252,537
ID,2020,6,1,26.67899642,289,30.9463481229,293,28.8273367103,582
ID,2020,6,2,7.717319504,291,28.357029703,303,18.2456565247,594
ID,2020,6,3,6.012862159,283,24.6983225806,310,15.7809780624,593
ID,2020,6,4,11.85131124,244,32.3870075758,264,22.5234053987,508
ID,2020,6,5,16.54331973,247,21.2530501931,259,18.9540315678,506
ID,2020,6,6,23.25849113,232,39.0885603113,257,31.5781798408,489
ID,2020,6,7,28.40703845,233,39.744122449,245,34.2178869432,478
ID,2020,6,8,15.77390631,256,41.7067886179,246,28.4820518234,502
ID,2020,6,9,18.45930768,260,27.2750194553,257,22.8415860673,517
ID,2020,6,10,13.70260142,246,44.7501260504,238,28.9697726226,484
ID,2020,6,11,39.99089118,247,18.4010288066,243,29.2840818805,490
ID,2020,6,12,22.46145546,213,32.6354330709,254,27.995053561,467
ID,2020,6,13,25.32815139,238,42.9308715596,218,33.7434869097,456
ID,2020,6,14,29.73797528,242,49.0016740088,227,39.0617697607,469
ID,2020,6,15,25.6768704,262,22.2428294574,258,23.9730577785,520
ID,2020,6,16,19.19704557,264,39.9271764706,255,29.3823700009,519
ID,2020,6,17,21.2419405,268,29.2331128405,257,25.1538096267,525
ID,2020,6,18,26.23934131,258,33.9884063745,251,30.0605895049,509
ID,2020,6,19,25.24532171,233,44.237027027,259,35.2429877204,492
ID,2020,6,20,13.31735165,219,46.4305761317,243,30.7340476436,462
ID,2020,6,21,25.25831214,237,38.0028378378,222,31.422331105,459
ID,2020,6,22,29.05290715,258,37.5689873418,237,33.1303031206,495
ID,2020,6,23,20.20957878,261,30.3523461538,260,25.2712285251,521
ID,2020,6,24,18.42603066,262,53.940078125,256,35.9773745809,518
ID,2020,6,25,14.58505687,265,45.4822519084,262,29.9457117088,527
ID,2020,6,26,24.35117837,263,32.0529113924,237,28.0017998226,500
ID,2020,6,27,33.68328213,262,50.662247191,267,42.2530055162,529
ID,2020,6,28,27.87787616,226,44.1624796748,246,36.3651907037,472
ID,2020,6,29,22.01073168,246,33.9907936508,252,28.0729317134,498
ID,2020,6,30,15.82927437,248,38.3480297398,269,27.5459962162,517
ID,2020,7,1,23.97819591,255,35.8264363636,275,30.1258678435,530
ID,2020,7,2,38.99714832,263,45.6008602151,279,42.3964760298,542
ID,2020,7,3,27.1658943,246,55.426322314,242,41.1802868807,488
ID,2020,7,4,24.17991907,247,39.0121212121,231,31.3477824483,478
ID,2020,7,5,26.13100816,238,39.7517120623,257,33.2027675598,495
ID,2020,7,6,18.22948507,272,50.2869465649,262,33.9580523203,534
ID,2020,7,7,20.47727916,283,31.3990421456,261,25.7173161807,544
ID,2020,7,8,31.18979328,290,50.5779003559,281,40.7310508778,571
ID,2020,7,9,22.48535212,284,41.4292565056,269,31.7003797506,553
ID,2020,7,10,24.93454231,273,38.5805072464,276,31.7948088354,549
ID,2020,7,11,26.87778189,257,30.6584920635,252,28.7495676733,509
ID,2020,7,12,18.86797663,257,25.8543461538,260,22.3814313228,517
ID,2020,7,13,14.8403788,264,57.0216091954,261,35.8104761966,525
ID,2020,7,14,19.47013596,294,49.4710763889,288,34.3159621516,582
ID,2020,7,15,23.97993277,297,47.5597163121,282,35.4643869304,579
ID,2020,7,16,30.46685519,318,32.6532258065,279,31.4886263826,597
ID,2020,7,17,27.33519158,287,75.5432580645,310,52.3678559187,597
ID,2020,7,18,27.97228934,249,34.2780566802,247,31.1124597695,496
ID,2020,7,19,20.1884789,217,43.319339207,227,32.0143917146,444
ID,2020,7,20,18.1643138,255,48.7888429752,242,33.0760563763,497
ID,2020,7,21,14.65783224,286,58.17866171,269,35.7517117489,555
ID,2020,7,22,20.76035342,283,37.9109411765,255,28.8893494756,538
ID,2020,7,23,15.97250847,291,34.310137931,290,25.125542108,581
ID,2020,7,24,18.6111696,265,42.633115942,276,30.8663584917,541
ID,2020,7,25,15.74740742,243,47.8621138211,246,31.9032719899,489
ID,2020,7,26,27.65084815,224,45.3618779343,213,36.2834553446,437
ID,2020,7,27,23.18209759,267,37.3474898785,247,29.9892024446,514
ID,2020,7,28,18.02650551,269,48.9508606557,244,32.7351656573,513
ID,2020,7,29,13.73437261,279,40.75425,240,26.2291135996,519
ID,2020,7,30,16.47288209,288,42.7455477032,283,29.4941857126,571
ID,2020,7,31,16.67393676,221,34.8665490196,255,26.4199790419,476
IL,2020,1,1,23.04301604,4917,29.1994157874,5118,26.1828719351,10035
IL,2020,1,2,19.56922343,4829,26.287322749,4598,22.8459626544,9427
IL,2020,1,3,17.43651303,4775,26.9687612428,4892,22.2603216839,9667
IL,2020,1,4,16.8138437,4787,23.6142923927,4706,20.185055282,9493
IL,2020,1,5,21.47357228,4798,26.3142281321,4813,23.8976776401,9611
IL,2020,1,6,16.98189957,4959,24.0802804132,4743,20.4520727652,9702
IL,2020,1,7,14.31965717,4988,21.4993962423,4737,17.816873004,9725
IL,2020,1,8,15.11170313,5014,17.3556156477,4678,16.1947636704,9692
IL,2020,1,9,19.98774444,5307,24.8035173534,4927,22.306223348,10234
IL,2020,1,10,19.36759423,4963,24.3379257154,4927,21.8437138689,9890
IL,2020,1,11,16.49962472,4823,18.9733945549,4628,17.7109893159,9451
IL,2020,1,12,21.64067861,4833,23.9022441195,4719,22.7579658419,9552
IL,2020,1,13,17.34152991,5072,23.1165331665,4794,20.1476687314,9866
IL,2020,1,14,13.16071334,4065,22.8094115243,4894,18.4314722321,8959
IL,2020,1,15,17.43166797,3807,16.5902974203,3295,17.041310893,7102
IL,2020,1,16,19.45508173,4894,21.8891767943,4361,20.6020388964,9255
IL,2020,1,17,14.62384506,4944,21.9768319559,5082,18.350942547,10026
IL,2020,1,18,18.98728259,4843,19.6158688097,4604,19.2936243869,9447
IL,2020,1,19,18.86415667,4737,23.1418281759,4912,21.0417836196,9649
IL,2020,1,20,19.29317031,4785,22.4595511111,4500,20.8277652055,9285
IL,2020,1,21,15.95500403,4984,19.0805348694,4861,17.498244803,9845
IL,2020,1,22,15.97920551,5060,18.8761788107,4776,17.3858692437,9836
IL,2020,1,23,15.22866453,5174,22.4860079051,4807,18.7239104577,9981
IL,2020,1,24,15.44018102,4971,24.9400020129,4968,20.1886577976,9939
IL,2020,1,25,19.5396995,5025,20.7824728666,4699,20.1402540094,9724
IL,2020,1,26,19.37052151,4928,23.7347393985,5353,21.6428353274,10281
IL,2020,1,27,16.81168381,4757,17.4301587667,4346,17.1069592315,9103
IL,2020,1,28,14.174704,5051,18.0755355594,4612,16.0365103906,9663
IL,2020,1,29,14.77261821,5095,19.9074219409,4740,17.2473482237,9835
IL,2020,1,30,17.31389568,5252,23.2976449054,4917,20.2072081927,10169
IL,2020,1,31,19.56943665,4917,25.4261915019,5107,22.5533200327,10024
IL,2020,2,1,18.50050048,5055,28.8224610126,4681,23.4632261634,9736
IL,2020,2,2,14.51368346,3456,22.2378897752,5516,19.2625378999,8972
IL,2020,2,3,21.2841062,2920,11.8052644231,2496,16.9157182614,5416
IL,2020,2,4,14.18463947,4535,16.2204755817,3911,15.1273525925,8446
IL,2020,2,5,16.00938929,4880,22.2092469112,5099,19.1773494073,9979
IL,2020,2,6,24.51659683,2386,20.8619238754,4335,22.1593572439,6721
IL,2020,2,7,13.81265717,2544,8.99352334419,1842,11.7887528136,4386
IL,2020,2,8,15.36417799,4684,19.14858337,4546,17.2280898922,9230
IL,2020,2,9,19.39589505,4441,20.8738969957,4660,20.1526788174,9101
IL,2020,2,10,17.07837276,4560,25.0614949064,4221,20.9158353019,8781
IL,2020,2,11,15.19203822,4499,20.4989452025,4617,17.8798387398,9116
IL,2020,2,12,20.93182098,4772,19.1544845749,3987,20.1227970906,8759
IL,2020,2,13,26.44240412,5715,24.3041483356,5137,25.430220194,10852
IL,2020,2,14,23.86351308,5508,27.3639982175,5610,25.62981292,11118
IL,2020,2,15,19.40653185,5118,25.1183456102,5023,22.2356848445,10141
IL,2020,2,16,29.47292623,5061,30.4909600313,5104,29.9840963748,10165
IL,2020,2,17,24.7689233,4913,41.4325958763,4850,33.0469947939,9763
IL,2020,2,18,17.53885316,5031,26.7886624738,4770,22.0405969032,9801
IL,2020,2,19,16.58129459,5021,22.118260957,4974,19.3367593933,9995
IL,2020,2,20,20.23078663,4907,26.7707551585,4701,23.4306609069,9608
IL,2020,2,21,21.59729998,4763,26.6918110236,4826,24.1612910423,9589
IL,2020,2,22,17.2025751,4629,22.2918570415,5638,19.9972932831,10267
IL,2020,2,23,20.27861559,4529,24.1291408326,4516,22.2011111119,9045
IL,2020,2,24,17.64846021,4897,23.3217092338,4581,20.3905106192,9478
IL,2020,2,25,17.16869161,5075,22.4388281094,5009,19.7865132805,10084
IL,2020,2,26,19.5928378,5180,21.6220260614,4758,20.5643489439,9938
IL,2020,2,27,21.02910037,5258,22.9293826656,4892,21.9449802705,10150
IL,2020,2,28,21.2618846,5200,24.975675413,5145,23.1089076771,10345
IL,2020,2,29,19.96375783,4766,22.4760744323,4756,21.2185969143,9522
IL,2020,3,1,24.02496461,4524,36.6114642701,4562,30.3445344371,9086
IL,2020,3,2,21.01119317,4735,30.6920856569,4483,25.7193121783,9218
IL,2020,3,3,16.51819939,4837,19.1515567055,4638,17.8072243218,9475
IL,2020,3,4,17.5330906,5041,25.4106430666,4774,21.3647192781,9815
IL,2020,3,5,20.8395454,5213,23.3110010235,4885,22.035134697,10098
IL,2020,3,6,22.18375131,4793,23.8757366389,4921,23.0408914998,9714
IL,2020,3,7,20.75644598,4488,22.5099055543,4447,21.6291527206,8935
IL,2020,3,8,24.75632563,4447,24.6569122966,4424,24.7067478386,8871
IL,2020,3,9,19.20930821,4785,25.8287693358,4396,22.3788051176,9181
IL,2020,3,10,13.64935271,5191,21.4407837723,4708,17.3549853437,9899
IL,2020,3,11,17.44936273,5932,22.0725968703,5368,19.6456035145,11300
IL,2020,3,12,17.89670489,6030,22.4031876387,5857,20.1171532335,11887
IL,2020,3,13,18.09443835,5475,23.2784596095,5583,20.7117643305,11058
IL,2020,3,14,18.06138965,5397,18.3303139465,4969,18.1903000136,10366
IL,2020,3,15,17.43621809,5648,19.9055863192,5526,18.6574216728,11174
IL,2020,3,16,13.27621929,6147,18.4804520859,5729,15.7867489033,11876
IL,2020,3,17,9.586827468,6323,15.7241307233,6028,12.5821852546,12351
IL,2020,3,18,6.926839899,6158,11.0274226087,5750,8.90688277612,11908
IL,2020,3,19,8.730165982,6205,11.4907981875,5738,10.0565084081,11943
IL,2020,3,20,10.21424224,5945,12.5514273734,5962,11.3845032432,11907
IL,2020,3,21,7.677707377,5618,10.7955462031,5465,9.21510602219,11083
IL,2020,3,22,5.823220025,5413,9.81715110863,5367,7.81166419252,10780
IL,2020,3,23,5.570213,5634,7.79593158098,5174,6.63570781292,10808
IL,2020,3,24,6.483890909,5793,9.88651728553,5467,8.13594760531,11260
IL,2020,3,25,6.084430928,5852,12.919779548,5398,9.3641830925,11250
IL,2020,3,26,5.464706923,5885,10.9425748185,5647,8.14711413821,11532
IL,2020,3,27,6.33267181,5573,10.8170362358,5547,8.56961151053,11120
IL,2020,3,28,4.997931158,5404,10.4090460653,5210,7.6540371187,10614
IL,2020,3,29,4.513309164,5379,10.7493712633,5185,7.57407989333,10564
IL,2020,3,30,5.803138706,5566,10.601955436,5206,8.12235889692,10772
IL,2020,3,31,6.21143303,5729,10.789979393,5338,8.4198255922,11067
IL,2020,4,1,6.121063211,5709,10.7272900274,5465,8.37388489991,11174
IL,2020,4,2,7.522522887,5569,10.2803517202,5203,8.85458595968,10772
IL,2020,4,3,5.679757365,5358,10.4016142638,5216,8.00898051463,10574
IL,2020,4,4,5.01353632,5090,9.30066518399,4946,7.12634414795,10036
IL,2020,4,5,4.95192504,5044,9.96302038295,4857,7.41015047993,9901
IL,2020,4,6,5.936553913,5322,11.8437410367,4881,8.76248553612,10203
IL,2020,4,7,5.492589176,5411,11.344748946,5218,8.36553768288,10629
IL,2020,4,8,5.791898519,4967,9.11358431981,5153,7.48326679287,10120
IL,2020,4,9,5.959832224,4709,11.5072580645,4402,8.64008340938,9111
IL,2020,4,10,5.898930449,4787,10.3424060935,4792,8.12182796319,9579
IL,2020,4,11,4.555425519,4759,8.49591620728,4535,6.47818485527,9294
IL,2020,4,12,5.843471715,4721,9.08055893867,4598,7.44065242693,9319
IL,2020,4,13,5.493201589,5010,9.8445783912,4637,7.58476728111,9647
IL,2020,4,14,4.180833011,5234,11.2368682235,4796,7.55478564103,10030
IL,2020,4,15,4.959573001,5199,9.17328492936,5096,7.04535017311,10295
IL,2020,4,16,5.866596924,5163,11.7887615643,4756,8.7061790421,9919
IL,2020,4,17,5.857828367,4964,10.9150009982,5009,8.39782412652,9973
IL,2020,4,18,5.758339015,4696,10.1668444056,4576,7.9340638497,9272
IL,2020,4,19,6.513086726,4623,10.233699957,4646,8.37800948692,9269
IL,2020,4,20,5.896647356,4665,10.6080995069,4462,8.19997807776,9127
IL,2020,4,21,6.105259209,4784,12.0293908514,4416,8.94884239738,9200
IL,2020,4,22,6.490750449,4997,11.639057261,4593,8.95646193886,9590
IL,2020,4,23,5.603096869,5160,9.00596122449,4900,7.2605556505,10060
IL,2020,4,24,7.045277133,4889,12.1491739573,4915,9.60399325818,9804
IL,2020,4,25,5.387876204,4459,8.62468997669,4290,6.97502114455,8749
IL,2020,4,26,5.393299967,4294,9.3114381814,4311,7.35623940248,8605
IL,2020,4,27,5.627529136,4375,14.6607018779,4260,10.0839640961,8635
IL,2020,4,28,5.522806666,4475,10.6174296524,4229,7.99812383161,8704
IL,2020,4,29,5.51122883,4606,12.5103509582,4331,8.90310506781,8937
IL,2020,4,30,8.845443861,4686,15.3787920837,4396,12.0078088453,9082
IL,2020,5,1,8.62938742,4522,16.8840786749,4830,12.8926635921,9352
IL,2020,5,2,5.364521839,4204,10.7772640587,4090,8.03369421403,8294
IL,2020,5,3,6.586942553,4144,12.0156141654,4038,9.26611341232,8182
IL,2020,5,4,5.895676755,4492,10.9937061565,4077,8.32124168321,8569
IL,2020,5,5,6.848078177,4553,9.96498522391,4399,8.37972184315,8952
IL,2020,5,6,8.008125167,4491,12.2995428296,4156,10.0707054614,8647
IL,2020,5,7,6.81541037,4447,12.4761078408,4247,9.58064871353,8694
IL,2020,5,8,7.665202021,4133,11.6247140178,4266,9.67630788818,8399
IL,2020,5,9,8.694741212,4096,11.5305244123,3871,10.072589432,7967
IL,2020,5,10,8.176410103,4028,15.5966683144,4046,11.8948104898,8074
IL,2020,5,11,7.174845197,4295,10.8972810358,3939,8.95559267927,8234
IL,2020,5,12,7.883908905,4390,11.0903855539,4098,9.4319934134,8488
IL,2020,5,13,6.101595322,4112,12.1116462389,4161,9.12441919063,8273
IL,2020,5,14,5.665367262,4166,10.400645933,3762,7.9123549462,7928
IL,2020,5,15,7.204709899,4153,11.40449415,4359,9.35542178225,8512
IL,2020,5,16,5.971771528,4132,10.6406360424,3962,8.25717320901,8094
IL,2020,5,17,7.385458677,4186,12.3356634078,4296,9.89265975264,8482
IL,2020,5,18,8.356815484,4277,13.5904403131,4088,10.9145032666,8365
IL,2020,5,19,7.486116958,4378,10.6397521472,4075,9.00641311276,8453
IL,2020,5,20,7.958469622,4378,11.788864598,4254,9.84615500523,8632
IL,2020,5,21,8.670892711,4335,11.3625627413,4144,9.98641112185,8479
IL,2020,5,22,7.839975304,4047,15.5866619318,4224,11.7962084458,8271
IL,2020,5,23,8.103565844,3828,13.9423557188,3812,11.0168468653,7640
IL,2020,5,24,8.817435664,3810,13.7012029064,3716,11.2288200744,7526
IL,2020,5,25,8.270204977,4001,12.1681286395,3778,10.163296068,7779
IL,2020,5,26,7.973200981,4205,12.8406756073,3952,10.3314527553,8157
IL,2020,5,27,7.967151616,4234,11.7305485232,4029,9.80216627643,8263
IL,2020,5,28,9.4415383,4388,11.449450444,4167,10.4195593291,8555
IL,2020,5,29,11.10571066,4327,14.6821018247,4439,12.9167533682,8766
IL,2020,5,30,10.12758904,4575,12.8553253346,4334,11.4545627857,8909
IL,2020,5,31,9.446018067,4646,13.0019518272,4816,11.2559289727,9462
IL,2020,6,1,7.964628889,4729,14.6468001713,4669,11.2843839132,9398
IL,2020,6,2,7.353354636,4540,13.895932614,4541,10.6250038594,9081
IL,2020,6,3,6.984656337,4336,12.8912403277,4394,9.9575692872,8730
IL,2020,6,4,8.87804109,4232,11.6757360039,4144,10.2621919643,8376
IL,2020,6,5,10.75340432,3895,16.171252989,4182,13.5585848491,8077
IL,2020,6,6,10.54126617,3633,15.4882965213,3622,13.0110310125,7255
IL,2020,6,7,9.832052802,3444,12.8483696575,3533,11.3594495987,6977
IL,2020,6,8,9.287513911,3777,14.6624661167,3394,11.8314530807,7171
IL,2020,6,9,8.014649576,4052,14.5985408163,3920,11.2520873158,7972
IL,2020,6,10,8.748417379,4025,11.9535074627,3886,10.3228049489,7911
IL,2020,6,11,12.65208742,3914,15.7691821465,3876,14.2030321132,7790
IL,2020,6,12,11.34506864,3571,17.5225114648,3707,14.4915072978,7278
IL,2020,6,13,9.206521094,3458,14.0820837017,3393,11.621173543,6851
IL,2020,6,14,10.73765774,3582,15.2226214689,3540,12.9669151958,7122
IL,2020,6,15,9.749105762,3847,17.5793604172,3643,13.5575994481,7490
IL,2020,6,16,8.27771581,3962,14.406836083,3758,11.2612953419,7720
IL,2020,6,17,9.646979751,4099,15.4969451563,3902,12.4999437569,8001
IL,2020,6,18,10.20505751,4174,17.9850394101,3933,13.9794091583,8107
IL,2020,6,19,11.30679617,3886,16.2921035599,4017,13.8407680522,7903
IL,2020,6,20,10.64791178,3831,17.6156818803,3659,14.0517930613,7490
IL,2020,6,21,11.91216456,3816,14.2523994709,3780,13.0767364351,7596
IL,2020,6,22,10.35275602,3926,14.5245231176,3785,12.4004980073,7711
IL,2020,6,23,10.3193037,4050,15.6945125986,3929,12.9661511449,7979
IL,2020,6,24,9.275578137,3987,15.062597874,3857,12.1211333544,7844
IL,2020,6,25,10.88692003,4026,16.0321963351,3820,13.3920124956,7846
IL,2020,6,26,10.85952461,3934,18.5194785661,3989,14.7160885795,7923
IL,2020,6,27,10.66173868,3773,14.0840833793,3622,12.3379702555,7395
IL,2020,6,28,12.51334899,3819,15.2504693333,3750,13.8694331871,7569
IL,2020,6,29,10.70781754,4000,14.0190637293,3813,12.3238141764,7813
IL,2020,6,30,9.468605221,3850,13.3108078491,3924,11.407993324,7774
IL,2020,7,1,12.78793741,3995,21.3633997013,4018,17.0879757835,8013
IL,2020,7,2,16.1402201,3907,17.8624412666,3916,17.0023213512,7823
IL,2020,7,3,11.68780962,3835,24.1299737671,3812,17.8901804489,7647
IL,2020,7,4,12.05548033,3633,16.1693925234,3638,14.1138509199,7271
IL,2020,7,5,15.79009432,3713,19.967055285,3491,17.8142157427,7204
IL,2020,7,6,12.80381529,3942,19.603681014,3787,16.1355647397,7729
IL,2020,7,7,10.39491455,4037,17.2315566401,3893,13.7511626782,7930
IL,2020,7,8,11.62647672,4195,18.9760231563,3973,15.2013724095,8168
IL,2020,7,9,12.01655909,4214,16.3536856641,3983,14.1240100043,8197
IL,2020,7,10,12.85147572,3937,20.4023509202,4075,16.6919420756,8012
IL,2020,7,11,10.73897707,3793,14.7680349345,3664,12.7186562997,7457
IL,2020,7,12,12.67810165,3856,19.0981196121,3712,15.827032236,7568
IL,2020,7,13,11.87134598,4064,18.0672210471,3782,14.8579378107,7846
IL,2020,7,14,8.597519257,4281,18.3947075,4000,13.329888895,8281
IL,2020,7,15,9.523215401,4183,14.9568906136,4123,12.2204274046,8306
IL,2020,7,16,12.74550721,4022,18.1392468403,3877,15.3928712494,7899
IL,2020,7,17,14.27551122,3932,18.7180552738,3944,16.5001676126,7876
IL,2020,7,18,14.16080354,3833,18.1394127069,3746,16.1272727232,7579
IL,2020,7,19,12.95972189,3991,18.7841099476,3820,15.8081615751,7811
IL,2020,7,20,11.28315995,4114,19.7305891089,4040,15.4685430506,8154
IL,2020,7,21,9.354856084,4170,16.4230043356,3921,12.7801693079,8091
IL,2020,7,22,10.4784324,4306,18.4350774818,4130,14.3737553241,8436
IL,2020,7,23,10.54130345,4350,17.0240590319,4235,13.7392615035,8585
IL,2020,7,24,10.63157594,4080,17.5112023121,4325,14.1716573272,8405
IL,2020,7,25,11.17658516,3804,15.249949762,3782,13.2073609213,7586
IL,2020,7,26,13.0538387,3819,15.7955472504,3746,14.4114646392,7565
IL,2020,7,27,11.2592691,4091,18.3048651479,3819,14.6609291894,7910
IL,2020,7,28,9.753011622,4227,18.232925689,4064,13.9096116423,8291
IL,2020,7,29,10.95122054,4211,14.4884417148,4152,12.7073537838,8363
IL,2020,7,30,13.5338996,4144,17.0949963424,4101,15.3051619093,8245
IL,2020,7,31,13.65401157,3789,19.0400151515,3960,16.4064408103,7749
IN,2020,1,1,22.3072073,2349,26.1757174008,2293,24.2181279508,4642
IN,2020,1,2,17.77893369,2232,22.1983498647,2218,19.9816898868,4450
IN,2020,1,3,20.65669347,2241,21.5256042497,2259,21.0928866814,4500
IN,2020,1,4,17.89754408,2268,19.0407192076,2322,18.4758562034,4590
IN,2020,1,5,17.05940497,2151,17.2344144981,2152,17.1469300698,4303
IN,2020,1,6,13.85096611,2215,18.2637783019,2120,16.0090195925,4335
IN,2020,1,7,11.26139433,2216,17.2259317343,2168,14.2110104551,4384
IN,2020,1,8,13.28597779,2255,18.5981598928,2239,15.9326123535,4494
IN,2020,1,9,12.70912214,2324,15.0752973218,2203,13.8605875532,4527
IN,2020,1,10,19.1567998,2228,17.6419115044,2260,18.3939549809,4488
IN,2020,1,11,16.71518519,2160,15.151345895,2229,15.9209728891,4389
IN,2020,1,12,17.81471623,2220,16.0427578373,2201,16.9325446801,4421
IN,2020,1,13,11.24132221,2337,18.7175895197,2290,14.9414847644,4627
IN,2020,1,14,10.80437569,1826,17.3556738544,2226,14.4033859847,4052
IN,2020,1,15,14.7532732,1717,13.0736702849,1474,13.9774240315,3191
IN,2020,1,16,14.11143358,2274,15.8825282833,2033,14.9474297564,4307
IN,2020,1,17,16.79671359,2276,20.4588119696,2239,18.6127575041,4515
IN,2020,1,18,14.23231171,2297,18.2424683544,2212,16.1995919268,4509
IN,2020,1,19,18.09705103,2116,20.742810171,2281,19.4695724311,4397
IN,2020,1,20,13.88331045,2184,21.3413652217,2007,17.4548484903,4191
IN,2020,1,21,10.88298495,2258,16.5622478121,2171,13.6668367616,4429
IN,2020,1,22,13.77074073,2268,18.2701975417,2278,16.0254179445,4546
IN,2020,1,23,15.07211073,2293,16.6756458898,2214,15.8598246958,4507
IN,2020,1,24,15.4568609,2214,18.4046227273,2200,16.9260670667,4414
IN,2020,1,25,15.30950893,2301,22.2438052681,2126,18.6396001915,4427
IN,2020,1,26,17.08450997,2255,16.5838004751,2526,16.8199644389,4781
IN,2020,1,27,10.13346658,2077,18.683573226,1987,14.3138459859,4064
IN,2020,1,28,12.24503766,2255,15.340032695,2141,13.7524044412,4396
IN,2020,1,29,12.39090248,2349,16.421634829,2251,14.3633325925,4600
IN,2020,1,30,13.8399655,2321,17.7639292196,2204,15.7512176631,4525
IN,2020,1,31,17.54559626,2264,16.9297106532,2281,17.2365016353,4545
IN,2020,2,1,18.23122667,2413,20.74625,2264,19.4486764923,4677
IN,2020,2,2,13.97599469,1508,19.0792561983,2541,17.1786095314,4049
IN,2020,2,3,15.01150963,1252,10.3679313725,1020,12.9268046024,2272
IN,2020,2,4,11.16862491,2058,15.5515022676,1764,13.1914913827,3822
IN,2020,2,5,11.29624936,2221,15.8947845528,2460,13.7129117344,4681
IN,2020,2,6,16.21765671,1084,13.8884449878,2045,14.6953690871,3129
IN,2020,2,7,10.8693295,1223,6.81191990577,849,9.20680983518,2072
IN,2020,2,8,15.07851822,2173,18.7550972447,2468,17.0336565594,4641
IN,2020,2,9,19.48546249,1935,17.4428094778,2068,18.4302023278,4003
IN,2020,2,10,11.31447412,1911,17.6358238173,1839,14.4144640116,3750
IN,2020,2,11,10.96147581,1904,16.6010141271,1982,13.8378435261,3886
IN,2020,2,12,12.65288109,2027,15.2991891892,1776,13.8887062765,3803
IN,2020,2,13,15.76781294,2373,18.3843410853,2193,17.0245028705,4566
IN,2020,2,14,15.8210837,2187,22.6641285591,2318,19.3420999005,4505
IN,2020,2,15,17.10163254,2052,18.0412863268,2099,17.5767790826,4151
IN,2020,2,16,17.76625694,1977,16.3218115565,1921,17.0544099462,3898
IN,2020,2,17,14.89038889,2134,17.7710385898,2099,16.3188046046,4233
IN,2020,2,18,14.12220705,2202,19.6486363636,2024,16.7690345301,4226
IN,2020,2,19,14.10276131,2267,16.1456710348,2213,15.1119039933,4480
IN,2020,2,20,18.42298199,2163,18.6864588407,2053,18.5512832174,4216
IN,2020,2,21,17.01662251,2117,18.5941140143,2105,17.8031264457,4222
IN,2020,2,22,13.83455595,2072,19.1125620466,2619,16.7812832932,4691
IN,2020,2,23,21.15318556,2031,16.078014007,1999,18.635749348,4030
IN,2020,2,24,19.12081955,2245,16.4305257937,2016,17.8479652405,4261
IN,2020,2,25,14.99165542,2374,15.7708291799,2207,15.3670399404,4581
IN,2020,2,26,17.18128112,2412,20.8881764438,2199,18.9491108353,4611
IN,2020,2,27,19.52267445,2479,26.0431533388,2426,22.7476860268,4905
IN,2020,2,28,21.22576596,2265,27.1435108225,2310,24.2137420545,4575
IN,2020,2,29,27.90953189,2051,23.8281431871,2165,25.8136574731,4216
IN,2020,3,1,21.85888041,1983,26.9453457172,1938,24.3729252367,3921
IN,2020,3,2,16.95669513,2103,23.4032266391,1937,20.0475197669,4040
IN,2020,3,3,14.2035998,2114,12.8339653465,2020,13.5343541309,4134
IN,2020,3,4,18.83023848,2139,21.1509043561,2112,19.9832016252,4251
IN,2020,3,5,18.27731122,2265,19.7606019417,2060,18.9838034482,4325
IN,2020,3,6,19.39839681,2177,24.2683125557,2246,21.8713406863,4423
IN,2020,3,7,22.46338717,2043,23.6212334594,2116,23.0524717452,4159
IN,2020,3,8,19.59322445,1898,18.9853668988,1867,19.2917981424,3765
IN,2020,3,9,14.7098565,2091,15.1841925466,1932,14.9376509922,4023
IN,2020,3,10,11.34188804,2394,15.2931837506,2117,13.1962203431,4511
IN,2020,3,11,15.33706805,2749,17.5285906572,2526,16.3865061743,5275
IN,2020,3,12,17.83273876,2702,20.4578039216,2805,19.1698202523,5507
IN,2020,3,13,15.21101379,2328,21.0538311688,2464,18.2153339113,4792
IN,2020,3,14,20.15249776,2238,17.8500734956,2177,19.01719139,4415
IN,2020,3,15,13.35573631,2397,12.6613788301,2154,13.0270951297,4551
IN,2020,3,16,10.04033022,2665,11.9684375,2528,10.9789505173,5193
IN,2020,3,17,9.384374768,2679,11.8213289166,2566,10.5766005726,5245
IN,2020,3,18,8.781369092,2761,11.2065583399,2554,9.94673754713,5315
IN,2020,3,19,7.601852955,2774,11.500832711,2678,9.51701579185,5452
IN,2020,3,20,9.480664542,2528,12.0926617013,2551,10.7925772715,5079
IN,2020,3,21,7.496437243,2456,10.4905889621,2428,8.98493035807,4884
IN,2020,3,22,6.37332342,2356,9.24210803689,2277,7.783257064,4633
IN,2020,3,23,4.149378242,2509,7.54063829787,2397,5.80629841198,4906
IN,2020,3,24,4.917110848,2634,9.91718985335,2523,7.36333914556,5157
IN,2020,3,25,6.257987398,2698,9.24105606759,2604,7.72307808371,5302
IN,2020,3,26,5.585947736,2680,11.201,2580,8.34009884648,5260
IN,2020,3,27,5.080677574,2509,7.91053677932,2515,6.49729698112,5024
IN,2020,3,28,5.392359747,2424,7.38546364824,2297,6.36210337359,4721
IN,2020,3,29,5.410936837,2455,7.95961177474,2344,6.65579911124,4799
IN,2020,3,30,5.123834971,2472,8.19300777874,2314,6.60776014382,4786
IN,2020,3,31,4.781123679,2563,9.36175675676,2294,6.94459336819,4857
IN,2020,4,1,6.317638162,2642,8.88104848246,2537,7.57335779571,5179
IN,2020,4,2,6.441024004,2500,10.0999764151,2544,8.28645916138,5044
IN,2020,4,3,6.132902231,2343,9.89376375953,2362,8.02092665829,4705
IN,2020,4,4,4.823803264,2206,7.93469890511,2192,6.37429968176,4398
IN,2020,4,5,4.740407539,2184,10.1314754879,2101,7.38372930342,4285
IN,2020,4,6,5.228054458,2349,10.2255994358,2127,7.60289319076,4476
IN,2020,4,7,4.154351893,2461,8.24910499139,2324,6.14310971968,4785
IN,2020,4,8,4.949928438,2236,8.44748979592,2450,6.77857234045,4686
IN,2020,4,9,6.08080404,2077,10.6937113951,1878,8.27120606601,3955
IN,2020,4,10,6.354084033,2118,11.2325022873,2186,8.83183085081,4304
IN,2020,4,11,4.733341496,2050,9.10394589076,1959,6.86903967743,4009
IN,2020,4,12,5.204209755,2069,9.98474658869,2052,7.58461780711,4121
IN,2020,4,13,3.86987553,2169,6.54004310345,2088,5.17955603114,4257
IN,2020,4,14,4.060365308,2272,8.63771334276,2121,6.27037104024,4393
IN,2020,4,15,5.240043307,2310,9.33628349179,2314,7.28993512958,4624
IN,2020,4,16,4.417493485,2302,11.3938151876,2186,7.81549688112,4488
IN,2020,4,17,5.346760256,2065,10.8911922366,2164,8.18387323921,4229
IN,2020,4,18,5.723800449,1934,7.69957840617,1945,6.71449086578,3879
IN,2020,4,19,4.38008951,1899,10.8141391753,1940,7.63147173209,3839
IN,2020,4,20,5.415997992,1964,9.6590792975,1879,7.49061411821,3843
IN,2020,4,21,4.631130646,2105,10.1466048429,1941,7.2770860133,4046
IN,2020,4,22,4.967445042,2184,10.1512372635,2061,7.48424027603,4245
IN,2020,4,23,5.285283718,2256,11.4284250903,2216,8.3293806055,4472
IN,2020,4,24,4.44133267,2011,9.35701532913,2218,7.01947978231,4229
IN,2020,4,25,4.812752336,1813,8.68074537541,1838,6.75999177901,3651
IN,2020,4,26,5.296793831,1809,8.1633869116,1742,6.70304704035,3551
IN,2020,4,27,6.296460545,1876,9.03226130653,1791,7.63265339035,3667
IN,2020,4,28,5.197492532,2018,10.4776893939,1848,7.7214976538,3866
IN,2020,4,29,6.135878569,2043,6.82827147941,1967,6.47551369488,4010
IN,2020,4,30,6.871189122,2094,11.0857233938,2039,8.95041374824,4133
IN,2020,5,1,7.785127002,1929,10.7627505938,2105,9.33889439436,4034
IN,2020,5,2,6.163310654,1761,11.5290903923,1759,8.84467615389,3520
IN,2020,5,3,7.074570643,1805,13.5283769634,1719,10.2227241801,3524
IN,2020,5,4,6.264223273,1944,12.4447807487,1870,9.29454379725,3814
IN,2020,5,5,5.597245852,1928,8.29131243358,1882,6.92801574873,3810
IN,2020,5,6,7.363549236,1930,9.49955771305,1854,8.41010307227,3784
IN,2020,5,7,8.06472304,1986,17.3351609553,1926,12.6288496824,3912
IN,2020,5,8,7.743965915,1818,11.6901530612,1960,9.7912202312,3778
IN,2020,5,9,9.04019843,1764,13.1737656904,1673,11.0522607013,3437
IN,2020,5,10,9.906486625,1722,10.1602494331,1764,10.0348967207,3486
IN,2020,5,11,7.48393673,1834,12.5048735245,1779,9.95618875251,3613
IN,2020,5,12,5.919952854,1908,10.2290866142,1905,8.07282455952,3813
IN,2020,5,13,6.851420523,1774,10.1051397849,1860,8.51678040941,3634
IN,2020,5,14,7.884113288,1748,8.49143730887,1635,8.17763228715,3383
IN,2020,5,15,7.475415043,1819,12.2185092838,1885,9.88921975249,3704
IN,2020,5,16,8.578653346,1760,11.5573960739,1732,10.0560824424,3492
IN,2020,5,17,9.530647934,1744,13.4805980449,1739,11.5027878257,3483
IN,2020,5,18,6.933624435,1832,12.7920865279,1826,9.85805083787,3658
IN,2020,5,19,6.14973311,1911,11.3390449119,1759,8.63692642322,3670
IN,2020,5,20,7.799383952,1883,12.1231874662,1851,9.94275843107,3734
IN,2020,5,21,10.06052192,1763,12.6250657174,1826,11.365302353,3589
IN,2020,5,22,11.04468155,1664,12.8778275666,1763,11.9877327398,3427
IN,2020,5,23,7.297621103,1631,12.1476510067,1639,9.72856881315,3270
IN,2020,5,24,12.27466628,1603,11.0969728097,1655,11.6764211316,3258
IN,2020,5,25,10.77051404,1673,13.0581110402,1567,11.8768919719,3240
IN,2020,5,26,7.276209721,1831,16.1638743747,1799,11.6808677684,3630
IN,2020,5,27,10.90366399,1905,11.915407489,1816,11.3974361465,3721
IN,2020,5,28,10.25289007,1955,13.8161989247,1860,11.9901782665,3815
IN,2020,5,29,11.8516345,1921,12.3969338484,2071,12.1345290267,3992
IN,2020,5,30,9.925383007,1919,12.223342147,1891,11.0659186327,3810
IN,2020,5,31,11.45127588,1928,13.8633316353,1963,12.6681521194,3891
IN,2020,6,1,7.588292551,2003,14.54367428,2014,11.0755065919,4017
IN,2020,6,2,5.873083122,1998,10.732493778,2009,8.30945846712,4007
IN,2020,6,3,5.679361475,1942,6.84218368344,2047,6.27607670706,3989
IN,2020,6,4,9.155969999,1799,14.0433154506,1864,11.6430057407,3663
IN,2020,6,5,9.148099914,1642,14.9238655462,1785,12.1564867402,3427
IN,2020,6,6,11.15688149,1536,14.0484012539,1595,12.6298850107,3131
IN,2020,6,7,12.17255368,1445,15.2816383812,1532,13.7725260556,2977
IN,2020,6,8,10.15031082,1609,14.4541497976,1482,12.213814335,3091
IN,2020,6,9,8.457295847,1727,11.6904358068,1698,10.0601780811,3425
IN,2020,6,10,8.991345244,1732,16.0037132785,1702,12.4668986496,3434
IN,2020,6,11,12.93680064,1666,19.189224088,1727,16.1192159936,3393
IN,2020,6,12,9.908041687,1583,14.9489069069,1665,12.4921059084,3248
IN,2020,6,13,12.90024231,1568,11.9312943495,1522,12.4229805638,3090
IN,2020,6,14,12.41310991,1656,18.1940745342,1610,15.2628812036,3266
IN,2020,6,15,8.87857809,1709,13.2441133896,1658,11.0282833252,3367
IN,2020,6,16,8.488729904,1740,15.2255116697,1671,11.7889827127,3411
IN,2020,6,17,9.754036456,1811,14.7967398649,1776,12.2507861784,3587
IN,2020,6,18,12.53007727,1812,14.6129424539,1842,13.5800602116,3654
IN,2020,6,19,13.50532537,1690,15.7167698368,1777,14.6387943107,3467
IN,2020,6,20,16.08486227,1670,18.508398533,1636,17.2841681763,3306
IN,2020,6,21,14.01285538,1653,20.6927380952,1680,17.3798529682,3333
IN,2020,6,22,9.49716568,1690,12.3209124311,1633,10.8848209447,3323
IN,2020,6,23,11.39770368,1694,11.8376456456,1665,11.6157755385,3359
IN,2020,6,24,9.919461077,1707,14.6830384381,1639,12.2528452057,3346
IN,2020,6,25,14.98393058,1697,15.0714966807,1657,15.0271914712,3354
IN,2020,6,26,13.5417275,1615,19.7522867514,1653,16.6831150283,3268
IN,2020,6,27,17.07318431,1633,15.3177918782,1576,16.2110782107,3209
IN,2020,6,28,16.93976412,1612,17.9925,1588,17.4621843005,3200
IN,2020,6,29,8.120884523,1741,16.3088805503,1599,12.0408263337,3340
IN,2020,6,30,12.47416344,1751,14.3887848384,1794,13.4430860884,3545
IN,2020,7,1,12.90022263,1752,23.3343804538,1719,18.0677009645,3471
IN,2020,7,2,18.35086051,1720,16.9008961187,1752,17.6191964508,3472
IN,2020,7,3,15.13278011,1705,19.6334543326,1708,17.3850952498,3413
IN,2020,7,4,17.28440205,1597,17.636786141,1674,17.4647416918,3271
IN,2020,7,5,19.29857489,1670,19.4345426065,1596,19.3650183914,3266
IN,2020,7,6,13.37202561,1866,19.3824380403,1735,16.2679060784,3601
IN,2020,7,7,10.6605269,1784,20.9960818713,1710,15.7188551773,3494
IN,2020,7,8,12.56690762,1840,20.6218345128,1837,16.5910851294,3677
IN,2020,7,9,14.36806773,1832,15.3637919827,1846,14.867824927,3678
IN,2020,7,10,16.49871146,1816,17.1201325967,1810,16.8089078906,3626
IN,2020,7,11,15.93749997,1828,19.6985909631,1682,17.7398233462,3510
IN,2020,7,12,17.11703725,1772,22.1403531489,1699,19.5758715088,3471
IN,2020,7,13,12.84188974,1831,16.0720750293,1706,14.3999039056,3537
IN,2020,7,14,7.58054481,1817,15.4217053824,1765,11.4442099162,3582
IN,2020,7,15,10.69178082,1825,14.3588936627,1862,12.543737455,3687
IN,2020,7,16,12.09399887,1818,16.2432426173,1727,14.1153652879,3545
IN,2020,7,17,14.27384655,1747,13.5251334469,1761,13.8979959871,3508
IN,2020,7,18,15.47330236,1723,15.6725794841,1667,15.5712949753,3390
IN,2020,7,19,16.47209379,1748,17.4661052632,1710,16.9636379251,3458
IN,2020,7,20,11.26723943,1746,16.9973930873,1707,14.0999565725,3453
IN,2020,7,21,11.48965519,1827,14.762642369,1756,13.093720355,3583
IN,2020,7,22,13.57872798,1926,17.4517200855,1872,15.4876909135,3798
IN,2020,7,23,13.41358437,1872,15.5515961945,1892,14.4882704412,3764
IN,2020,7,24,12.40881197,1734,16.2508984375,1792,14.3614548939,3526
IN,2020,7,25,15.87477125,1683,20.4286389062,1609,18.1005224829,3292
IN,2020,7,26,15.04697587,1617,21.3335651075,1582,18.1558799568,3199
IN,2020,7,27,10.91907726,1734,15.9110194175,1648,13.3515789382,3382
IN,2020,7,28,8.958730335,1843,15.3187320711,1743,12.0500529859,3586
IN,2020,7,29,10.06424474,1847,12.3234465195,1767,11.1688406294,3614
IN,2020,7,30,13.73656688,1838,19.4875628843,1789,16.5732175146,3627
IN,2020,7,31,13.89595546,1706,14.2981012658,1738,14.0988966361,3444
KS,2020,1,1,34.38938017,855,35.0883418367,784,34.7237218092,1639
KS,2020,1,2,25.3827854,797,33.3093484848,660,28.9734042305,1457
KS,2020,1,3,25.17970986,827,29.7793828892,713,27.3092987365,1540
KS,2020,1,4,25.66235081,855,25.3909321059,869,25.5255394098,1724
KS,2020,1,5,25.99716395,811,21.3694013605,735,23.7970310242,1546
KS,2020,1,6,23.36441304,852,28.7769425901,749,25.896570837,1601
KS,2020,1,7,21.90595025,884,26.7754602774,793,24.2085867746,1677
KS,2020,1,8,24.93828827,888,26.8938767651,779,25.8521475607,1667
KS,2020,1,9,23.66651848,945,26.8258267717,889,25.1979389115,1834
KS,2020,1,10,25.60996692,906,26.9430414747,868,26.2622266232,1774
KS,2020,1,11,18.61083586,1017,23.1025717566,871,20.6830296979,1888
KS,2020,1,12,28.31462887,1078,20.5521028466,1089,24.4136640156,2167
KS,2020,1,13,20.12233032,1017,24.7643578485,911,22.315736481,1928
KS,2020,1,14,18.33622572,771,22.2436153846,910,20.4514693814,1681
KS,2020,1,15,24.09947309,702,23.1257528958,518,23.6860410731,1220
KS,2020,1,16,25.45300963,927,29.2622760291,826,27.2479064045,1753
KS,2020,1,17,22.99221637,943,20.403429229,869,21.7506843471,1812
KS,2020,1,18,23.48265912,1147,25.6072413793,841,24.3814386371,1988
KS,2020,1,19,28.0530941,1157,24.6818435754,1253,26.300323599,2410
KS,2020,1,20,30.13481445,1051,33.6177225434,865,31.7072129368,1916
KS,2020,1,21,19.65265964,1049,24.4773900293,1023,22.0347538428,2072
KS,2020,1,22,25.92486748,1019,25.0305263158,950,25.4933671722,1969
KS,2020,1,23,27.85542791,958,34.1438327526,861,30.8319625826,1819
KS,2020,1,24,31.1978611,935,28.2649015064,863,29.7901057444,1798
KS,2020,1,25,25.67059183,997,34.2033333333,831,29.5495350408,1828
KS,2020,1,26,31.22066262,1011,25.9329561672,981,28.6166264603,1992
KS,2020,1,27,21.23408065,941,26.611438172,744,23.608415366,1685
KS,2020,1,28,21.62166171,1005,30.2142685851,834,25.5184720057,1839
KS,2020,1,29,24.11343547,1045,29.7874200426,938,26.7973474867,1983
KS,2020,1,30,25.76699717,1099,29.4844069641,919,27.4599107482,2018
KS,2020,1,31,34.86927306,1018,32.4113039117,997,33.6530967618,2015
KS,2020,2,1,29.20956495,1195,33.9428854626,908,31.253243041,2103
KS,2020,2,2,20.47100852,932,25.2586753247,1540,23.4536164808,2472
KS,2020,2,3,33.6158851,644,18.8665423729,590,26.5639303115,1234
KS,2020,2,4,15.40787878,891,22.9408571429,735,18.8130073758,1626
KS,2020,2,5,20.28402218,900,23.6415037594,931,21.991185124,1831
KS,2020,2,6,23.70138204,398,24.2321003963,757,24.0492208242,1155
KS,2020,2,7,19.22993532,463,17.7510365854,328,18.6166878042,791
KS,2020,2,8,23.65500003,870,27.2097552448,858,25.4200347373,1728
KS,2020,2,9,24.28911165,833,27.7549936789,791,25.9772352244,1624
KS,2020,2,10,24.26415432,881,31.0539382239,777,27.4460976815,1658
KS,2020,2,11,20.01018362,871,23.7071498771,814,21.7961364588,1685
KS,2020,2,12,24.33704312,859,23.6858167331,753,24.0328412159,1612
KS,2020,2,13,25.45869771,1029,29.0094687131,847,27.0618443196,1876
KS,2020,2,14,29.84063567,928,27.8734671126,897,28.8737588503,1825
KS,2020,2,15,27.40536607,833,27.6435611038,761,27.5190840253,1594
KS,2020,2,16,34.70110065,836,30.5238235294,714,32.776858157,1550
KS,2020,2,17,33.28066012,909,24.2210968495,857,28.8842582384,1766
KS,2020,2,18,26.59890566,996,29.0345080946,803,27.6860589424,1799
KS,2020,2,19,22.59460244,1006,29.4539213483,890,25.8144304086,1896
KS,2020,2,20,32.04946877,941,28.4033605601,857,30.3115851572,1798
KS,2020,2,21,28.99023536,892,35.9775517241,870,32.4402723843,1762
KS,2020,2,22,26.66559237,844,29.7085291309,1047,28.3503913063,1891
KS,2020,2,23,29.96542961,838,24.087785059,763,27.1642785841,1601
KS,2020,2,24,23.80321135,956,28.140723192,802,25.7819852392,1758
KS,2020,2,25,22.05598945,955,26.5629213483,890,24.2300649999,1845
KS,2020,2,26,27.26015771,952,25.8038970588,816,26.5880374095,1768
KS,2020,2,27,30.10473902,958,27.1657497182,887,28.6917940277,1845
KS,2020,2,28,30.11195056,933,34.8514415437,881,32.4137650896,1814
KS,2020,2,29,35.11957982,833,25.8333448674,867,30.3835999942,1700
KS,2020,3,1,35.64940533,824,33.6374964235,699,34.7260144399,1523
KS,2020,3,2,26.55490128,912,26.9008259212,787,26.7151382974,1699
KS,2020,3,3,32.27641181,942,25.9094379391,854,29.2489086442,1796
KS,2020,3,4,28.88654212,937,30.9683783784,851,29.8773937172,1788
KS,2020,3,5,32.68103266,949,34.1339739027,843,33.3645312468,1792
KS,2020,3,6,29.38699354,908,35.5358253589,836,32.334484022,1744
KS,2020,3,7,35.85669088,828,38.6218886199,826,37.2376179254,1654
KS,2020,3,8,31.86830537,773,26.0056958393,697,29.0885510551,1470
KS,2020,3,9,21.12523533,871,32.2419382022,712,26.1252937286,1583
KS,2020,3,10,23.18395772,945,27.1680147059,816,25.0300624903,1761
KS,2020,3,11,19.86716762,1151,28.4815862808,933,23.723814746,2084
KS,2020,3,12,22.36772177,1150,29.769083558,1113,26.0078966131,2263
KS,2020,3,13,25.47075286,943,32.1822645291,998,28.9215970876,1941
KS,2020,3,14,26.66930243,860,34.4165144231,832,30.4788061996,1692
KS,2020,3,15,21.85997872,941,19.3872193878,784,20.736127522,1725
KS,2020,3,16,14.53601912,1148,23.2146285141,996,18.5676865437,2144
KS,2020,3,17,16.97439406,1147,21.4579680568,1127,19.1964643742,2274
KS,2020,3,18,12.60684468,1030,21.3709639831,944,16.7979939313,1974
KS,2020,3,19,14.29594008,1069,14.6672060302,995,14.4749176093,2064
KS,2020,3,20,17.68622806,1026,23.2243482688,982,20.3946115486,2008
KS,2020,3,21,14.47854478,1017,19.4749616648,913,16.8421347364,1930
KS,2020,3,22,13.32862828,1006,19.5183054393,956,16.344597375,1962
KS,2020,3,23,11.51288602,991,13.7045424476,907,12.560216041,1898
KS,2020,3,24,12.99946443,1083,14.2552033368,959,13.5892066492,2042
KS,2020,3,25,15.67850875,1073,17.8563045587,1031,16.7456700992,2104
KS,2020,3,26,14.26927808,1039,19.5994246862,956,16.8234736467,1995
KS,2020,3,27,12.04044081,930,15.6259251101,908,13.8117246754,1838
KS,2020,3,28,13.19843559,946,25.7512181617,903,19.3288642878,1849
KS,2020,3,29,15.51001079,927,19.8365306122,882,17.6194582655,1809
KS,2020,3,30,12.25151763,962,23.1496076233,892,17.4948273787,1854
KS,2020,3,31,12.79993233,1035,14.9053150057,873,13.7632442146,1908
KS,2020,4,1,11.37386287,1007,19.8853684211,950,15.5056616812,1957
KS,2020,4,2,12.24905505,963,16.4498864926,881,14.2560683368,1844
KS,2020,4,3,12.59745221,942,23.67201726,927,18.0902942653,1869
KS,2020,4,4,18.12938576,879,18.6813942308,832,18.3978083478,1711
KS,2020,4,5,11.16219826,837,16.928259773,793,13.9674048734,1630
KS,2020,4,6,9.359753401,892,13.0035212888,869,11.1578421543,1761
KS,2020,4,7,12.352671,936,15.3514590747,843,13.7736818752,1779
KS,2020,4,8,14.52811176,895,24.0593103448,928,19.379978072,1823
KS,2020,4,9,13.32298357,848,15.8941097724,747,14.5271411081,1595
KS,2020,4,10,9.99683678,803,18.6734363853,841,14.4354135854,1644
KS,2020,4,11,13.2262086,786,11.4449470899,756,12.3529052916,1542
KS,2020,4,12,12.79407034,796,13.7723131171,709,13.2549169373,1505
KS,2020,4,13,8.903209369,860,13.5564433618,821,11.1758477438,1681
KS,2020,4,14,8.772720939,849,13.9497587455,829,11.3303874119,1678
KS,2020,4,15,10.48914804,892,17.1243632075,848,13.7228620987,1740
KS,2020,4,16,10.82664689,844,15.5755168269,832,13.1840811308,1676
KS,2020,4,17,9.146761704,772,19.993081761,795,14.6495214011,1567
KS,2020,4,18,11.22148704,733,15.8739943741,711,13.5122991692,1444
KS,2020,4,19,10.85186682,691,14.1130044843,669,12.4560588034,1360
KS,2020,4,20,13.71091837,784,12.1787055477,703,12.9865433773,1487
KS,2020,4,21,12.33125909,826,19.0600943396,742,15.5154400563,1568
KS,2020,4,22,12.84875287,866,12.8648445596,772,12.8563369874,1638
KS,2020,4,23,13.42756097,902,15.115035461,846,14.2442677317,1748
KS,2020,4,24,14.20180572,803,12.5969647059,850,13.3765698688,1653
KS,2020,4,25,12.86092855,700,16.2831930334,689,14.5585097084,1389
KS,2020,4,26,9.883742211,636,12.1071226415,636,10.9954324263,1272
KS,2020,4,27,9.844480446,741,16.0079510703,654,12.7340215129,1395
KS,2020,4,28,14.09321104,763,16.6481041968,691,15.3074002913,1454
KS,2020,4,29,13.86378579,803,14.95375,712,14.3760329963,1515
KS,2020,4,30,19.33749704,823,18.7636871508,716,19.0705393528,1539
KS,2020,5,1,13.98975247,727,23.7388615783,773,19.0137933638,1500
KS,2020,5,2,10.72736759,661,18.031563981,633,14.3004404768,1294
KS,2020,5,3,13.66629098,701,15.4368445122,656,14.5222107421,1357
KS,2020,5,4,10.44584757,761,15.1655510204,735,12.7646858294,1496
KS,2020,5,5,11.11379681,748,13.8319971264,696,12.4239543032,1444
KS,2020,5,6,14.34869575,736,20.7882956259,663,17.4004861129,1399
KS,2020,5,7,12.98888739,755,17.474610951,694,15.1373291784,1449
KS,2020,5,8,14.197982,669,21.525773639,698,17.9396049437,1367
KS,2020,5,9,13.30585215,663,18.2067307692,624,15.682035723,1287
KS,2020,5,10,17.75705086,668,17.7143835616,657,17.7358943204,1325
KS,2020,5,11,13.37997157,705,17.9003755869,639,15.5291815155,1344
KS,2020,5,12,15.00425532,752,16.8816831683,707,15.9140164501,1459
KS,2020,5,13,12.4020402,696,18.7321142857,700,15.5761461169,1396
KS,2020,5,14,12.2793129,684,14.084046875,640,13.1516918607,1324
KS,2020,5,15,17.40739857,715,25.7968940493,689,21.524465796,1404
KS,2020,5,16,21.5856535,635,25.0400312989,639,23.3182652845,1274
KS,2020,5,17,19.96494658,655,19.0187312187,599,19.5129665151,1254
KS,2020,5,18,13.21468232,724,23.5294728682,645,18.0744631115,1369
KS,2020,5,19,14.39932415,725,17.903703125,640,16.0424029368,1365
KS,2020,5,20,17.51616101,745,39.3216591252,663,27.7839488299,1408
KS,2020,5,21,20.86904178,741,25.6755274262,711,23.2226308257,1452
KS,2020,5,22,27.04171091,678,37.5420576132,729,32.4821890526,1407
KS,2020,5,23,22.97570457,603,32.6911478261,575,27.7179625261,1178
KS,2020,5,24,31.70179293,647,31.9963666121,611,31.8448648853,1258
KS,2020,5,25,31.26468378,711,49.2363798701,616,39.6072344895,1327
KS,2020,5,26,22.1031786,689,39.3994009217,651,30.5060448175,1340
KS,2020,5,27,25.40607788,719,41.8191476408,657,33.2428415667,1376
KS,2020,5,28,22.44286273,786,32.5811756168,689,27.1786576988,1475
KS,2020,5,29,26.9176589,739,31.1278998609,719,28.9939025563,1458
KS,2020,5,30,26.77168791,711,37.0689655172,667,31.7559289579,1378
KS,2020,5,31,34.10874338,756,40.8884692418,699,37.3658075569,1455
KS,2020,6,1,33.64242959,852,47.3509987196,781,40.1987017824,1633
KS,2020,6,2,27.4535266,811,59.5578361076,781,43.2031910004,1592
KS,2020,6,3,20.70656347,742,43.4873790323,744,32.1123015442,1486
KS,2020,6,4,22.77507108,704,33.476295754,683,28.0446719829,1387
KS,2020,6,5,23.10774996,680,38.2079237288,708,30.8101440726,1388
KS,2020,6,6,19.71922472,619,31.3606514085,568,25.2898484429,1187
KS,2020,6,7,22.47395974,596,27.4762431942,551,24.876974721,1147
KS,2020,6,8,28.58833065,647,32.1247906198,597,30.2854902979,1244
KS,2020,6,9,21.39036816,679,39.0079027356,658,30.0607778464,1337
KS,2020,6,10,25.68356623,701,26.775276873,614,26.1933079295,1315
KS,2020,6,11,24.88806986,658,43.037752809,623,33.7149648461,1281
KS,2020,6,12,22.30160991,615,43.1856612903,620,32.7859110078,1235
KS,2020,6,13,23.77247467,590,37.4891099476,573,30.53054175,1163
KS,2020,6,14,24.31609136,614,35.6238103757,559,29.7048508909,1173
KS,2020,6,15,20.65195189,666,35.5442639594,591,27.6538265384,1257
KS,2020,6,16,21.67151782,672,30.1260666667,600,25.659512559,1272
KS,2020,6,17,20.1561711,713,33.1346749226,646,26.3254966845,1359
KS,2020,6,18,24.27710996,737,38.6133087149,677,31.1410467048,1414
KS,2020,6,19,26.12377787,675,40.6104532578,706,33.5297103999,1381
KS,2020,6,20,26.28125765,652,38.6682009724,617,32.3039085798,1269
KS,2020,6,21,29.75647405,658,40.4825769854,617,34.9470666078,1275
KS,2020,6,22,21.03315541,656,31.8986258278,604,26.2416824992,1260
KS,2020,6,23,21.26600871,679,42.6529206349,630,31.5591748771,1309
KS,2020,6,24,24.3236667,690,29.5471749599,623,26.8021477708,1313
KS,2020,6,25,21.85201408,715,28.8950715421,629,25.1482068952,1344
KS,2020,6,26,24.07985079,670,28.4388872404,674,26.2658556766,1344
KS,2020,6,27,26.16656606,629,36.9800993377,604,31.4637064491,1233
KS,2020,6,28,23.45532847,700,32.7619284603,643,27.9111317416,1343
KS,2020,6,29,23.47895369,755,31.0427596439,674,27.046487079,1429
KS,2020,6,30,17.02968123,690,35.9654674221,706,26.6060888601,1396
KS,2020,7,1,23.34099202,746,28.9478654971,684,26.0228811517,1430
KS,2020,7,2,23.39456655,738,42.8314685315,715,32.9591810832,1453
KS,2020,7,3,39.35800307,676,46.6703053435,655,42.956468877,1331
KS,2020,7,4,32.57611948,603,62.2411147011,619,47.6028232786,1222
KS,2020,7,5,24.83577041,610,43.1667155963,545,33.4854371862,1155
KS,2020,7,6,23.79067564,740,31.0149028401,669,27.2207735796,1409
KS,2020,7,7,17.6742591,749,31.4240813253,664,24.1356051422,1413
KS,2020,7,8,25.79614253,757,30.647080292,685,28.1005061687,1442
KS,2020,7,9,24.87627121,767,26.6289985896,709,25.7181978442,1476
KS,2020,7,10,27.45651059,705,35.1488789238,669,31.2019213726,1374
KS,2020,7,11,21.53919577,659,36.3911821086,626,28.7744824999,1285
KS,2020,7,12,25.35816108,658,36.1657278481,632,30.6530310005,1290
KS,2020,7,13,23.14071137,717,30.7381674566,633,26.7030741128,1350
KS,2020,7,14,25.81687833,756,28.861408046,696,27.2762396815,1452
KS,2020,7,15,29.15378082,775,35.1732676056,710,32.031784603,1485
KS,2020,7,16,22.49500662,759,30.6434637681,690,26.3752243096,1449
KS,2020,7,17,31.93906613,664,25.4417503805,657,28.707622945,1321
KS,2020,7,18,25.2919836,610,44.0561001789,559,34.2647305355,1169
KS,2020,7,19,27.49467568,663,28.9822535211,568,28.1810641558,1231
KS,2020,7,20,27.26013633,734,36.8488294798,692,31.9132749412,1426
KS,2020,7,21,22.83030921,744,35.4287237237,666,28.7810496824,1410
KS,2020,7,22,23.90673604,769,44.9842212518,687,33.8519505596,1456
KS,2020,7,23,18.54579726,740,32.4029050279,716,25.3601442118,1456
KS,2020,7,24,18.48211619,671,44.0408431953,676,31.3089160828,1347
KS,2020,7,25,20.82753717,605,36.9739629005,593,28.8198831284,1198
KS,2020,7,26,27.26559456,656,28.5561209964,562,27.861059139,1218
KS,2020,7,27,20.00565151,706,30.8150866142,635,25.1242132484,1341
KS,2020,7,28,18.53430653,757,31.5777635783,626,24.4382863653,1383
KS,2020,7,29,21.2395871,775,30.2198150782,703,25.5109675254,1478
KS,2020,7,30,21.77393297,745,32.4963988522,697,26.9567060074,1442
KS,2020,7,31,27.13713831,636,33.9863117284,648,30.5937305025,1284
KY,2020,1,1,40.72374357,1170,52.5641463415,1230,46.7919499904,2400
KY,2020,1,2,33.74395967,1139,40.762354049,1062,37.1303907606,2201
KY,2020,1,3,28.02088518,1141,33.3588422972,1097,30.637390523,2238
KY,2020,1,4,26.53321998,1146,27.7686263287,1223,27.1710004631,2369
KY,2020,1,5,27.52,1081,20.9756676004,1071,24.2630390335,2152
KY,2020,1,6,16.07072436,1132,27.2549586017,1087,21.5494366722,2219
KY,2020,1,7,15.91026054,1151,21.5939520958,1169,18.7741551214,2320
KY,2020,1,8,16.08671736,1182,22.5560146252,1094,19.1963004919,2276
KY,2020,1,9,22.21976558,1194,25.3470146678,1159,23.7601317903,2353
KY,2020,1,10,22.06599653,1149,24.413506383,1175,23.252882966,2324
KY,2020,1,11,23.59807223,1162,24.3717320261,1224,23.9949538689,2386
KY,2020,1,12,24.55629963,1208,22.4845396536,1097,23.5703036673,2305
KY,2020,1,13,19.4482641,1325,20.694928,1250,20.0534407505,2575
KY,2020,1,14,13.36632008,981,20.290454902,1275,17.2795611695,2256
KY,2020,1,15,16.56997847,930,18.0639948119,771,17.2471604804,1701
KY,2020,1,16,18.02161732,1150,19.3622404372,1098,18.6764234511,2248
KY,2020,1,17,18.51319578,1139,30.2864472498,1109,24.3212633423,2248
KY,2020,1,18,22.9233016,1151,19.2166529943,1219,21.0168017475,2370
KY,2020,1,19,27.78175697,1087,16.1198635123,1099,21.9188013844,2186
KY,2020,1,20,20.72830653,1116,24.6043013972,1002,22.561992487,2118
KY,2020,1,21,13.91036363,1155,18.1298776224,1144,16.0100260951,2299
KY,2020,1,22,15.45520446,1174,23.0604358759,1193,19.2883439105,2367
KY,2020,1,23,21.41036709,1199,24.2186094421,1165,22.7942936298,2364
KY,2020,1,24,22.05867708,1149,26.7324232082,1172,24.4187074386,2321
KY,2020,1,25,21.12214227,1181,20.920795053,1132,21.0236013925,2313
KY,2020,1,26,20.61213371,1181,16.7281643625,1302,18.5755134561,2483
KY,2020,1,27,20.68246872,1114,20.7072573044,1061,20.6945609904,2175
KY,2020,1,28,14.302349,1192,20.7717425569,1142,17.4677506461,2334
KY,2020,1,29,13.64344675,1146,18.7482894737,1140,16.1891688432,2286
KY,2020,1,30,21.42809834,1220,18.5000965759,1139,20.0143662462,2359
KY,2020,1,31,24.46871398,1182,23.4368189369,1204,23.9480091888,2386
KY,2020,2,1,26.07825024,1223,23.4609785408,1165,24.8013986782,2388
KY,2020,2,2,23.10398908,727,15.4279786423,1311,18.1661825619,2038
KY,2020,2,3,20.4941722,604,15.5515858209,536,18.1702894814,1140
KY,2020,2,4,15.33304592,1067,15.569,940,15.4435575469,2007
KY,2020,2,5,18.95681407,1221,19.8199767261,1289,19.4000876412,2510
KY,2020,2,6,30.05244573,552,19.6541113281,1024,23.2961675399,1576
KY,2020,2,7,12.70029793,638,6.26574766355,428,10.1168199619,1066
KY,2020,2,8,22.14538939,1156,22.1107841615,1288,22.1271522647,2444
KY,2020,2,9,27.51801017,990,34.7433488806,1072,31.274345329,2062
KY,2020,2,10,17.45077278,1061,21.5980658436,972,19.4336399014,2033
KY,2020,2,11,16.30126861,1072,17.123516791,1072,16.7123927005,2144
KY,2020,2,12,19.73972477,1090,19.2699799398,997,19.5153186389,2087
KY,2020,2,13,26.64463756,1255,23.6434332192,1168,25.1979158637,2423
KY,2020,2,14,27.31747825,1150,26.677103336,1229,26.9866582545,2379
KY,2020,2,15,27.4863688,1041,25.217572305,1141,26.2999816319,2182
KY,2020,2,16,27.52778608,1066,17.7775075377,995,22.8205919269,2061
KY,2020,2,17,18.78010057,1094,18.748100189,1058,18.7643680407,2152
KY,2020,2,18,14.68088643,1207,27.0787851315,1103,20.6007488836,2310
KY,2020,2,19,17.35501255,1199,22.1122258862,1213,19.7474253928,2412
KY,2020,2,20,21.97662637,1156,22.3164157706,1116,22.1435299664,2272
KY,2020,2,21,24.49816016,1136,25.3826995516,1115,24.9363038391,2251
KY,2020,2,22,22.89772689,1047,22.4422392211,1438,22.634148915,2485
KY,2020,2,23,24.14557357,1046,26.9991295337,965,25.51488312,2011
KY,2020,2,24,17.16516856,1157,19.121835443,1106,18.1214538329,2263
KY,2020,2,25,18.94768665,1232,20.6192844974,1174,19.76333747,2406
KY,2020,2,26,16.87297949,1215,18.8264354697,1139,17.8181733561,2354
KY,2020,2,27,22.61028531,1227,18.5271379898,1174,20.6137776241,2401
KY,2020,2,28,27.40093042,1204,24.6222799665,1193,26.0179809035,2397
KY,2020,2,29,27.60318551,1105,21.2018158348,1162,24.3220246972,2267
KY,2020,3,1,24.74775864,1035,23.1193395253,969,23.9603643675,2004
KY,2020,3,2,18.03920003,1150,27.6125206992,1087,22.6910549998,2237
KY,2020,3,3,17.00499186,1232,18.61245,1200,17.7981455475,2432
KY,2020,3,4,22.05819106,1183,21.3768646288,1145,21.7230884983,2328
KY,2020,3,5,29.16284992,1200,22.2523282783,1121,25.8251959948,2321
KY,2020,3,6,25.05212035,1179,26.8358718861,1124,25.9226964362,2303
KY,2020,3,7,26.45802587,1079,30.9462553926,1159,28.7823592108,2238
KY,2020,3,8,26.00963746,993,27.493812038,947,26.7341288648,1940
KY,2020,3,9,20.41630526,1134,27.8082843602,1055,23.9789082526,2189
KY,2020,3,10,17.9816181,1267,20.2939084507,1136,19.0747358022,2403
KY,2020,3,11,21.29076023,1526,26.3619616858,1305,23.6284210918,2831
KY,2020,3,12,23.92063826,1426,24.6899412916,1533,24.3191991074,2959
KY,2020,3,13,25.91607576,1162,21.3653993344,1202,23.6022377467,2364
KY,2020,3,14,24.89338535,1155,19.5038112858,1081,22.2877817886,2236
KY,2020,3,15,21.93721382,1267,15.2755067265,1115,18.8189084425,2382
KY,2020,3,16,17.19723039,1437,15.0116138763,1326,16.1483243107,2763
KY,2020,3,17,10.25136177,1410,20.3264204545,1408,15.2853158608,2818
KY,2020,3,18,9.384989243,1395,16.3402296296,1350,12.8055992692,2745
KY,2020,3,19,11.36119769,1411,14.7389759036,1328,12.998908339,2739
KY,2020,3,20,11.23919226,1337,15.6679294824,1333,13.450243465,2670
KY,2020,3,21,9.853808462,1242,13.8371270718,1267,11.8653129174,2509
KY,2020,3,22,8.193149425,1178,12.2990338983,1180,10.2478329189,2358
KY,2020,3,23,5.859765553,1237,16.7970420168,1190,11.2225010256,2427
KY,2020,3,24,9.266459953,1322,13.2233283019,1325,11.2471364027,2647
KY,2020,3,25,10.43180925,1332,11.9590936786,1313,11.1899659437,2645
KY,2020,3,26,9.71186615,1345,12.3044487578,1288,10.980094938,2633
KY,2020,3,27,9.319283441,1256,21.1372065379,1346,15.4326287478,2602
KY,2020,3,28,9.028553656,1210,11.2041949153,1180,10.1027196334,2390
KY,2020,3,29,10.21835326,1172,14.9771452561,1191,12.6168810921,2363
KY,2020,3,30,9.562124091,1257,16.5576272649,1159,12.9179966815,2416
KY,2020,3,31,7.239985131,1343,13.8846977124,1224,10.4083249049,2567
KY,2020,4,1,6.667434544,1298,16.7133411397,1281,11.6572780295,2579
KY,2020,4,2,6.118960833,1251,16.5627725322,1165,11.1549875836,2416
KY,2020,4,3,8.823736282,1183,13.5782612313,1202,11.219937116,2385
KY,2020,4,4,6.624028677,1117,12.9167307692,1092,9.73477140435,2209
KY,2020,4,5,7.473532599,1104,11.4500649954,1077,9.43718477272,2181
KY,2020,4,6,5.833680274,1220,16.2725159526,1097,10.7760206881,2317
KY,2020,4,7,7.291035015,1285,14.1476,1225,10.6373665316,2510
KY,2020,4,8,8.106251076,1139,12.2377486507,1297,10.3059852116,2436
KY,2020,4,9,6.883990603,1065,14.9057228916,996,10.7605773858,2061
KY,2020,4,10,7.192212055,1094,13.9347074707,1111,10.5894512418,2205
KY,2020,4,11,8.409860065,1072,13.0297681159,1035,10.6792501138,2107
KY,2020,4,12,7.299826275,1036,9.85790018832,1062,8.59471402331,2098
KY,2020,4,13,6.373583916,1091,11.7623084112,1070,9.04176309688,2161
KY,2020,4,14,5.712886339,1223,16.4527705628,1155,10.9292724948,2378
KY,2020,4,15,7.483886664,1235,13.5273913043,1242,10.5141784538,2477
KY,2020,4,16,5.822337406,1138,13.0819841967,1139,9.45375492667,2277
KY,2020,4,17,5.861481454,1053,12.7588682582,1131,9.43334247759,2184
KY,2020,4,18,6.474223322,985,10.5254427861,1005,8.52019094079,1990
KY,2020,4,19,5.833459981,1000,12.384828629,992,9.09598894629,1992
KY,2020,4,20,6.635796712,1092,13.0395364238,1057,9.7855188504,2149
KY,2020,4,21,8.984841047,1101,10.7841666667,1044,9.86059673322,2145
KY,2020,4,22,8.990112337,1157,12.6445041705,1079,10.7535688613,2236
KY,2020,4,23,5.929047205,1186,13.9478044739,1207,9.9736105245,2393
KY,2020,4,24,7.685490364,1040,11.2068727915,1132,9.52075965864,2172
KY,2020,4,25,9.34957843,925,8.9080190678,944,9.12655433266,1869
KY,2020,4,26,9.885978233,920,12.567003367,891,11.205024834,1811
KY,2020,4,27,7.715297106,993,10.5741666667,936,9.10249353357,1929
KY,2020,4,28,8.239365096,1008,12.1126818675,921,10.0886780802,1929
KY,2020,4,29,9.94775771,1106,13.2876095618,1004,11.5369573589,2110
KY,2020,4,30,14.29273075,1062,15.4393756004,1041,14.8603281296,2103
KY,2020,5,1,9.376721463,973,17.0379300292,1029,13.3144755162,2002
KY,2020,5,2,10.79449946,869,16.0978242229,933,13.5403385298,1802
KY,2020,5,3,10.30138015,855,12.4779094077,861,11.3934498999,1716
KY,2020,5,4,8.950073272,956,12.8928540305,918,10.8814888197,1874
KY,2020,5,5,9.266051801,1003,15.8786353945,938,12.4616228523,1941
KY,2020,5,6,9.575253294,967,13.7606609808,938,11.6360997036,1905
KY,2020,5,7,9.720544517,955,14.8942038217,942,12.289646818,1897
KY,2020,5,8,10.98320364,899,12.5686284545,977,11.8088753051,1876
KY,2020,5,9,14.21425101,821,15.671699422,865,14.9619929295,1686
KY,2020,5,10,14.00142347,843,17.7712804878,820,15.8602826129,1663
KY,2020,5,11,10.68328703,937,12.3656678281,861,11.4889209939,1798
KY,2020,5,12,10.98197231,938,14.7142050209,956,12.8658236678,1894
KY,2020,5,13,7.922254363,865,13.8735276074,978,11.080336421,1843
KY,2020,5,14,8.424545512,869,14.6602377972,799,11.4115467925,1668
KY,2020,5,15,14.37600874,912,14.4596288441,943,14.4185175045,1855
KY,2020,5,16,17.51944506,865,14.2395154185,908,15.8397066988,1773
KY,2020,5,17,11.01990629,854,15.1346760895,849,13.0712507174,1703
KY,2020,5,18,11.05033053,938,14.3050858369,932,12.6724866509,1870
KY,2020,5,19,12.70947909,960,12.6188552189,891,12.6658562541,1851
KY,2020,5,20,11.26574592,992,15.3137088204,941,13.2363269284,1933
KY,2020,5,21,17.86318972,975,16.394226254,937,17.1433054273,1912
KY,2020,5,22,19.07961466,908,24.0917096774,930,21.6156583848,1838
KY,2020,5,23,16.8380168,837,14.4775724638,828,15.6641742112,1665
KY,2020,5,24,17.50127274,825,16.3795005675,881,16.9219753872,1706
KY,2020,5,25,20.1137513,861,14.0047613365,838,17.100606162,1699
KY,2020,5,26,13.21993322,898,16.8360784314,867,14.9962493097,1765
KY,2020,5,27,13.93471799,922,18.5764945055,910,16.2404039229,1832
KY,2020,5,28,15.33941756,1030,17.2485683761,936,16.2483520279,1966
KY,2020,5,29,14.99028046,1034,18.6831307551,1086,16.881995281,2120
KY,2020,5,30,14.99069894,973,17.0728877551,980,16.0355248687,1953
KY,2020,5,31,21.08716624,1034,15.2801733478,923,18.3483545693,1957
KY,2020,6,1,13.28716781,1031,19.2086723164,1062,16.291772581,2093
KY,2020,6,2,9.513196028,995,13.4008206687,987,11.4491624863,1982
KY,2020,6,3,12.60070164,1012,16.4627572016,972,14.4927974091,1984
KY,2020,6,4,17.59814806,972,15.1636105477,986,16.3721756457,1958
KY,2020,6,5,17.89546046,923,23.6359123344,981,20.8531197503,1904
KY,2020,6,6,14.85518258,822,15.8855311778,866,15.3837855929,1688
KY,2020,6,7,17.12365107,808,19.6762836186,818,18.4078167679,1626
KY,2020,6,8,11.22399998,845,16.2540391677,817,13.696648606,1662
KY,2020,6,9,9.786720607,927,11.8465197216,862,10.7792006723,1789
KY,2020,6,10,14.42286891,969,15.2236275565,929,14.8148103129,1898
KY,2020,6,11,13.51625646,959,16.3012004287,933,14.8895929943,1892
KY,2020,6,12,16.8202406,873,19.6405945946,925,18.2712013592,1798
KY,2020,6,13,22.85288687,814,23.7336233766,770,23.2810226718,1584
KY,2020,6,14,23.35518567,835,19.9882012579,795,21.7130061561,1630
KY,2020,6,15,15.90981051,950,13.540326087,828,14.8063610711,1778
KY,2020,6,16,13.94027514,945,15.8912568908,907,14.8957505439,1852
KY,2020,6,17,14.35110985,937,19.0484009009,888,16.6366958518,1825
KY,2020,6,18,18.53205344,974,20.4092364793,943,19.4554669017,1917
KY,2020,6,19,24.43770688,894,20.3034174553,951,22.3066991603,1845
KY,2020,6,20,18.45262902,852,22.9128742515,835,20.6602785566,1687
KY,2020,6,21,24.44687014,885,18.0416565901,827,21.3527628936,1712
KY,2020,6,22,15.90848803,959,22.8574713959,874,19.2218603496,1833
KY,2020,6,23,12.57786852,943,17.613916501,1006,15.177285795,1949
KY,2020,6,24,13.66461122,913,20.2913380282,852,16.8634617812,1765
KY,2020,6,25,22.63269968,926,19.1997643098,891,20.9492954891,1817
KY,2020,6,26,20.06537581,865,21.4550680272,882,20.7669834434,1747
KY,2020,6,27,18.39168032,851,24.8702712264,848,21.6252560049,1699
KY,2020,6,28,16.36578825,888,19.1351925466,805,17.6826048234,1693
KY,2020,6,29,15.67087472,926,20.7565178571,896,18.1718276568,1822
KY,2020,6,30,12.50851219,894,14.9326271186,944,13.7535418378,1838
KY,2020,7,1,22.83896397,917,19.8133371041,884,21.3538700502,1801
KY,2020,7,2,25.63447401,903,20.5790492958,852,23.1802165419,1755
KY,2020,7,3,21.19632261,843,25.5638442522,809,23.3351392011,1652
KY,2020,7,4,21.2045844,818,30.0833217189,861,25.7576474325,1679
KY,2020,7,5,23.73402977,804,25.5822443559,753,24.6278676526,1557
KY,2020,7,6,17.89406035,894,23.4154365541,859,20.5996291802,1753
KY,2020,7,7,10.8966518,899,19.2346931818,880,15.0211466938,1779
KY,2020,7,8,16.10148112,952,19.5691555556,900,17.7866360833,1852
KY,2020,7,9,17.72347152,965,19.7206646526,993,18.7363483232,1958
KY,2020,7,10,17.83368133,891,21.7127754678,962,19.8475445575,1853
KY,2020,7,11,19.09616255,800,19.9637959668,843,19.5413329519,1643
KY,2020,7,12,22.29144208,853,20.3554424242,825,21.3395948118,1678
KY,2020,7,13,14.86740982,915,15.181097852,838,15.0173645096,1753
KY,2020,7,14,13.33087405,961,17.7942731278,908,15.4992883692,1869
KY,2020,7,15,14.68311367,1047,18.8527013252,981,16.7000591778,2028
KY,2020,7,16,17.85678462,961,19.2047352342,982,18.5380442717,1943
KY,2020,7,17,20.35076312,878,26.3840162272,986,23.5421727572,1864
KY,2020,7,18,22.05849998,800,25.0086708075,805,23.5381806754,1605
KY,2020,7,19,18.80503413,876,20.3512405063,790,19.5382292304,1666
KY,2020,7,20,17.38913366,935,17.8775109649,912,17.6302815225,1847
KY,2020,7,21,13.41024645,974,12.3948196721,915,12.9183907053,1889
KY,2020,7,22,16.19943504,1009,17.7399567568,925,16.9362409283,1934
KY,2020,7,23,14.68949201,1004,24.3670763132,1009,19.5403030194,2013
KY,2020,7,24,18.13180371,937,17.0053313253,996,17.5513761388,1933
KY,2020,7,25,17.27505789,864,20.673156708,887,18.9964249097,1751
KY,2020,7,26,18.72596107,874,22.2527831325,830,20.4438380136,1704
KY,2020,7,27,15.29120206,965,16.7877200903,886,16.0075256553,1851
KY,2020,7,28,14.53562324,1035,17.5678501629,921,15.9633742604,1956
KY,2020,7,29,17.55152072,1039,16.2791091091,999,16.9278017802,2038
KY,2020,7,30,16.09273534,1009,17.9520658683,1002,17.0191645739,2011
KY,2020,7,31,16.22703625,911,20.1413580247,972,18.2475995878,1883
LA,2020,1,1,26.42995358,3014,37.2954776675,3224,32.045607581,6238
LA,2020,1,2,22.99837346,3000,32.0921021747,2897,27.4658199729,5897
LA,2020,1,3,19.51665553,3002,27.6428385251,3146,23.674913777,6148
LA,2020,1,4,17.98342687,3137,24.9349532086,2992,21.3769603673,6129
LA,2020,1,5,22.77905059,3023,29.9252017045,3520,26.6235335371,6543
LA,2020,1,6,17.98023036,2821,29.6490599503,2819,23.8125762138,5640
LA,2020,1,7,18.18160491,2779,26.9837438939,2866,22.650503108,5645
LA,2020,1,8,14.00738337,2851,23.8833989971,2792,18.8937621811,5643
LA,2020,1,9,18.50894893,3035,24.4700271186,2950,21.4471578952,5985
LA,2020,1,10,20.44434735,2873,27.3887115127,2988,23.9846578974,5861
LA,2020,1,11,15.95406923,2917,19.496122801,2899,17.7196148459,5816
LA,2020,1,12,20.94394278,3254,26.7531924577,3076,23.7668893849,6330
LA,2020,1,13,18.20829722,3735,23.6215131227,3734,20.9145427924,7469
LA,2020,1,14,19.59953496,2688,45.6477751386,3789,34.8375744901,6477
LA,2020,1,15,14.84214762,2384,18.4329528986,2208,16.5687369177,4592
LA,2020,1,16,16.9297542,2807,20.6000549249,2731,18.7397201227,5538
LA,2020,1,17,19.00285314,2839,26.1192240779,2874,22.5828373997,5713
LA,2020,1,18,15.12634579,2846,24.8893127386,2881,20.0376619728,5727
LA,2020,1,19,15.57353323,2785,28.1415457627,2950,22.0383347943,5735
LA,2020,1,20,16.32660974,2870,26.0654513399,2836,21.1670154143,5706
LA,2020,1,21,12.78238749,2978,21.5662979301,2947,17.1513637038,5925
LA,2020,1,22,13.68723502,3067,17.2718344738,3069,15.4801189385,6136
LA,2020,1,23,13.81692286,2928,22.4175237449,2948,18.1318601317,5876
LA,2020,1,24,14.67979705,2710,27.0036242083,2842,20.9882114563,5552
LA,2020,1,25,15.01409014,2929,21.2807472775,2663,17.9983726788,5592
LA,2020,1,26,17.12070781,2967,24.8485047299,3277,21.1764397938,6244
LA,2020,1,27,12.14923106,2796,17.8534384273,2696,14.9494027756,5492
LA,2020,1,28,11.56444172,2866,22.5061519347,2817,16.9881259844,5683
LA,2020,1,29,11.94187286,2910,20.7150991792,2924,16.3390126881,5834
LA,2020,1,30,14.67387208,2939,23.289897084,2915,18.964222761,5854
LA,2020,1,31,16.72217508,2832,23.1433423545,2956,20.0015410896,5788
LA,2020,2,1,17.54053592,2892,31.8054652369,2891,24.6717672282,5783
LA,2020,2,2,12.75400555,2137,21.6610379177,3112,18.0347608802,5249
LA,2020,2,3,18.90037024,1837,18.8106584362,1701,18.8572385898,3538
LA,2020,2,4,9.403903492,2631,19.3424778013,2365,14.1086129078,4996
LA,2020,2,5,13.84603625,2818,21.603999346,3058,17.8834513534,5876
LA,2020,2,6,22.88618727,1516,18.0662259161,2647,19.8214652658,4163
LA,2020,2,7,9.170423697,1581,7.27388111888,1144,8.37422380365,2725
LA,2020,2,8,15.85378581,2726,20.584142166,2687,18.2019231698,5413
LA,2020,2,9,18.48179748,2587,30.39570753,2749,24.6196045878,5336
LA,2020,2,10,12.91909737,2681,21.4108993494,2613,17.1104609084,5294
LA,2020,2,11,9.852524094,2591,18.6908357558,2752,14.4048418356,5343
LA,2020,2,12,15.56749523,2599,21.7954423155,2453,18.5914766633,5052
LA,2020,2,13,17.92195362,2851,20.3231829226,2881,19.1288520186,5732
LA,2020,2,14,17.14539011,2666,29.3449808429,2871,23.4710222202,5537
LA,2020,2,15,16.9127853,2585,22.009426945,2635,19.4855153258,5220
LA,2020,2,16,19.48733855,2619,27.3779299731,2599,23.4175123922,5218
LA,2020,2,17,15.28765489,2776,26.26754216,2787,20.788454067,5563
LA,2020,2,18,11.95831389,2912,23.3518259325,2815,17.558582163,5727
LA,2020,2,19,14.84430542,2901,21.136451723,2931,18.0065620753,5832
LA,2020,2,20,22.2940726,2895,21.323568917,2844,21.8131329808,5739
LA,2020,2,21,22.80311213,2818,26.8134680253,2846,24.8182026805,5664
LA,2020,2,22,18.42757517,2862,26.8119237102,3644,23.123635127,6506
LA,2020,2,23,26.24868833,2958,39.4281709291,3089,32.9811873789,6047
LA,2020,2,24,26.73352863,3038,28.2175139573,3045,27.4763751402,6083
LA,2020,2,25,23.92906942,3052,37.0770470664,3102,30.5564705671,6154
LA,2020,2,26,25.30343538,2975,46.0229310345,3190,36.0244720609,6165
LA,2020,2,27,19.57866405,2949,29.8706991597,2975,24.7472670971,5924
LA,2020,2,28,18.66032327,2846,32.3387989112,2939,25.6095090798,5785
LA,2020,2,29,18.36261871,2780,27.5558389262,2831,23.0010087353,5611
LA,2020,3,1,21.59529725,2809,32.6201578394,2851,27.1486325045,5660
LA,2020,3,2,15.44084932,2861,25.4162923656,2921,20.4803285895,5782
LA,2020,3,3,12.13364257,2932,19.7013409169,2901,15.8973821387,5833
LA,2020,3,4,15.22586946,2927,24.0123879599,2990,19.6659050041,5917
LA,2020,3,5,17.23830513,2897,21.4896829185,2933,19.377120062,5830
LA,2020,3,6,19.97909522,2763,28.0323183391,2890,24.0961684226,5653
LA,2020,3,7,18.0401942,2677,26.9176351351,2664,22.468110817,5341
LA,2020,3,8,19.24368884,2700,30.6368060139,2727,24.9685885145,5427
LA,2020,3,9,14.05366489,2906,22.9644338624,2835,18.4539488191,5741
LA,2020,3,10,11.7759319,3112,20.2729716981,2968,15.9238289593,6080
LA,2020,3,11,15.36756234,3368,25.4761077664,3322,20.3870822064,6690
LA,2020,3,12,15.38492312,3447,22.0073364486,3424,18.6850458441,6871
LA,2020,3,13,15.46743101,3079,25.4543549329,3426,20.7272621183,6505
LA,2020,3,14,15.02734344,2778,24.1176630624,2867,19.6441629896,5645
LA,2020,3,15,16.46219087,2871,27.9749823197,2828,22.1751535336,5699
LA,2020,3,16,11.2475697,3086,26.2034848977,3079,18.7170365116,6165
LA,2020,3,17,11.97290313,3045,21.4584669887,3105,16.7619561026,6150
LA,2020,3,18,8.744580807,2958,20.9895180317,2967,14.8763493717,5925
LA,2020,3,19,9.073773398,2992,18.6619428178,2903,13.7954792208,5895
LA,2020,3,20,9.700292963,2867,18.4702561576,3045,14.2172987018,5912
LA,2020,3,21,7.281039543,2732,16.3706453926,2789,11.8727639977,5521
LA,2020,3,22,5.251282521,2729,17.2842972774,2718,11.2556398017,5447
LA,2020,3,23,6.406006379,2827,14.5480799151,2828,10.4777630475,5655
LA,2020,3,24,5.763916592,2852,14.5985579937,2871,10.1959025197,5723
LA,2020,3,25,6.474479071,2918,12.7949367089,2923,9.63741310207,5841
LA,2020,3,26,5.755167586,2924,14.3622534247,2920,10.0557648907,5844
LA,2020,3,27,6.435133668,2768,14.2848324698,2895,10.4480028241,5663
LA,2020,3,28,6.252261611,2768,13.8641891892,2738,10.03748822,5506
LA,2020,3,29,4.832885037,2766,15.8307155699,2781,10.3466702744,5547
LA,2020,3,30,5.71186199,2739,13.8022687609,2865,9.84801748583,5604
LA,2020,3,31,6.617488957,2728,15.0189481537,2681,10.7817174847,5409
LA,2020,4,1,4.40815597,2744,13.1572316777,2879,8.88772007499,5623
LA,2020,4,2,4.254633159,2726,16.5036781193,2765,10.4226552525,5491
LA,2020,4,3,5.021819852,2676,11.5095174649,2777,8.32575094883,5453
LA,2020,4,4,4.325385474,2672,14.0623850019,2587,9.11519680291,5259
LA,2020,4,5,3.109440157,2733,13.6104194506,2694,8.32219825854,5427
LA,2020,4,6,4.636530894,2750,11.555638572,2717,8.07520211423,5467
LA,2020,4,7,5.153950672,2678,12.6663022388,2680,8.9115285367,5358
LA,2020,4,8,4.193024399,2460,14.0717126057,2721,9.38119475421,5181
LA,2020,4,9,4.617255402,2361,10.640248927,2330,7.60885099214,4691
LA,2020,4,10,5.669726102,2373,11.8789987889,2477,8.84093609073,4850
LA,2020,4,11,4.911882494,2348,12.2830270502,2329,8.58248238099,4677
LA,2020,4,12,6.114991633,2386,12.1791727791,2454,9.18968182569,4840
LA,2020,4,13,4.179595433,2447,13.3056330428,2409,8.70690692433,4856
LA,2020,4,14,4.653416397,2488,11.2897966507,2508,7.98488991108,4996
LA,2020,4,15,5.353784574,2497,12.7130085609,2453,9.00068890531,4950
LA,2020,4,16,5.612637298,2476,16.5399920319,2510,11.1135719915,4986
LA,2020,4,17,5.738957877,2399,14.5298342765,2474,10.2020459567,4873
LA,2020,4,18,4.020064076,2341,13.8179598805,2343,8.92110375788,4684
LA,2020,4,19,3.811742521,2330,12.0557407407,2430,8.02033825083,4760
LA,2020,4,20,6.839219148,2331,14.6117780528,2424,10.8015078515,4755
LA,2020,4,21,4.531682571,2306,13.8265394295,2384,9.25640298694,4690
LA,2020,4,22,5.488491311,2532,13.3963688999,2418,9.35136969686,4950
LA,2020,4,23,4.868495036,2618,14.3968105951,2756,9.75499255755,5374
LA,2020,4,24,4.949686418,2328,15.5950659938,2576,10.5415497514,4904
LA,2020,4,25,4.347030889,2233,15.5449187527,2277,10.0005986641,4510
LA,2020,4,26,6.294854172,2194,16.1637117904,2290,11.3349264169,4484
LA,2020,4,27,5.284016304,2216,14.395234657,2216,9.83962548052,4432
LA,2020,4,28,5.393243599,2229,12.1567611336,2223,8.77044473993,4452
LA,2020,4,29,5.995859047,2299,14.2196923744,2308,10.1158085411,4607
LA,2020,4,30,5.693705688,2283,14.6483110151,2315,10.2021683527,4598
LA,2020,5,1,8.003514254,2174,21.139733388,2438,14.9475954007,4612
LA,2020,5,2,5.036128882,2064,16.3425265188,2074,10.7029893699,4138
LA,2020,5,3,5.748109495,2137,14.9454342667,2107,10.3142648423,4244
LA,2020,5,4,7.160212842,2302,14.0420540062,2259,10.5686932608,4561
LA,2020,5,5,4.280359405,2226,19.0688282914,2347,11.8702427368,4573
LA,2020,5,6,6.778760176,2218,18.2786838535,2211,12.5196342448,4429
LA,2020,5,7,6.013315682,2262,18.2822157824,2243,12.1218934679,4505
LA,2020,5,8,5.927440896,2114,17.9582532751,2290,12.1832447898,4404
LA,2020,5,9,6.98073394,2071,18.0644168618,2135,12.6069020423,4206
LA,2020,5,10,7.744839793,2091,18.3034971645,2116,13.0555407671,4207
LA,2020,5,11,6.373106024,2141,18.4004964871,2135,12.3783629554,4276
LA,2020,5,12,5.218820331,2204,19.0661133787,2205,12.1440371988,4409
LA,2020,5,13,4.674753363,2129,14.7754626335,2248,9.86241487545,4377
LA,2020,5,14,4.899753802,2112,16.2069949749,1990,10.3852267259,4102
LA,2020,5,15,7.629258055,2143,21.6092632486,2321,14.8979838736,4464
LA,2020,5,16,8.935896448,2086,15.265708314,2153,12.1508256642,4239
LA,2020,5,17,8.229871087,2094,18.6706108283,2161,13.5324418463,4255
LA,2020,5,18,6.588694055,2167,20.2215266486,2214,13.4782378492,4381
LA,2020,5,19,6.789163345,2259,16.0926094808,2215,11.3951385776,4474
LA,2020,5,20,6.731921145,2259,17.1655371179,2290,11.9842800322,4549
LA,2020,5,21,6.997164983,2194,20.0621303587,2286,13.6637968689,4480
LA,2020,5,22,8.308387706,2115,25.1225711704,2213,16.9058433452,4328
LA,2020,5,23,6.993976031,2002,20.6060531401,2070,13.913671418,4072
LA,2020,5,24,7.512954967,2000,20.247141409,1973,13.8367782366,3973
LA,2020,5,25,7.5007423,2115,20.8604863813,2056,14.0861256208,4171
LA,2020,5,26,6.861395012,2215,15.6163457232,2233,11.2565849711,4448
LA,2020,5,27,9.502772797,2236,18.1966455122,2206,13.8203511873,4442
LA,2020,5,28,8.210911492,2260,16.9230204259,2301,12.6061236509,4561
LA,2020,5,29,10.24622691,2160,18.9231688643,2351,14.7683928454,4511
LA,2020,5,30,8.363051111,2091,20.5463599089,2195,14.6025198024,4286
LA,2020,5,31,9.090624654,2113,18.2479159049,2188,13.7491118098,4301
LA,2020,6,1,8.199594726,2295,24.666823832,2333,16.5008145843,4628
LA,2020,6,2,6.626796822,2407,18.807715311,2508,12.8424109767,4915
LA,2020,6,3,7.102419315,2385,15.3781993569,2488,11.327771407,4873
LA,2020,6,4,8.617726895,2226,19.4272297297,2368,14.1895385434,4594
LA,2020,6,5,7.134541878,2063,19.3395911111,2250,13.5016554357,4313
LA,2020,6,6,8.805584078,2020,20.3534575261,2013,14.5694990919,4033
LA,2020,6,7,6.685721921,2064,17.9438024231,2146,12.4244014359,4210
LA,2020,6,8,7.112802672,2098,18.3264140927,2072,12.6846498815,4170
LA,2020,6,9,6.832693915,2153,18.188614082,2244,12.6281646575,4397
LA,2020,6,10,8.940886823,2165,15.6927218935,2197,12.3415703741,4362
LA,2020,6,11,11.05637223,2117,19.6465793041,2213,15.446702081,4330
LA,2020,6,12,10.02708214,2022,25.5720568401,2076,17.9019887963,4098
LA,2020,6,13,11.13040168,1942,23.3401376598,2034,17.3765291908,3976
LA,2020,6,14,10.74831771,2021,25.3170573811,2039,18.0649827813,4060
LA,2020,6,15,9.386204194,2155,22.2555449786,2101,15.7392316819,4256
LA,2020,6,16,7.750486499,2220,15.3599175069,2182,11.5223580254,4402
LA,2020,6,17,9.228036774,2231,20.4892393238,2248,14.8800089401,4479
LA,2020,6,18,13.52971439,2241,22.2206594886,2229,17.8635212412,4470
LA,2020,6,19,11.87511811,2032,27.4713351376,2217,20.012753589,4249
LA,2020,6,20,9.03739624,2024,21.674592145,1986,15.2961172044,4010
LA,2020,6,21,13.5276667,2040,25.1254454023,2088,19.3939849971,4128
LA,2020,6,22,9.102856523,2153,19.6362759575,2167,14.386634281,4320
LA,2020,6,23,8.904904184,2192,18.4979338104,2236,13.7490808427,4428
LA,2020,6,24,6.752183734,2134,16.0498203593,2171,11.4409570472,4305
LA,2020,6,25,8.772463634,2131,18.9866350068,2211,13.9736457863,4342
LA,2020,6,26,8.612644136,2046,21.594546292,2171,15.2959995026,4217
LA,2020,6,27,8.827617628,1998,18.914713788,2009,13.8850112355,4007
LA,2020,6,28,11.0227077,2083,17.8483707597,2093,14.4437117191,4176
LA,2020,6,29,9.710276878,2167,20.0749555452,2137,14.8564939579,4304
LA,2020,6,30,7.09372987,2110,22.8826678603,2234,15.2135474276,4344
LA,2020,7,1,10.77875112,2146,23.3053029633,2261,17.2054662817,4407
LA,2020,7,2,14.19356706,2111,24.4921045392,2181,19.4268173494,4292
LA,2020,7,3,11.26495218,1987,21.8591489362,2115,16.7273427552,4102
LA,2020,7,4,10.03069854,1947,16.2954137235,1982,13.1909595463,3929
LA,2020,7,5,15.49334815,2025,21.6951392405,1975,18.5554825009,4000
LA,2020,7,6,11.31977096,2139,27.261146789,2180,19.3661241221,4319
LA,2020,7,7,8.245496776,2194,18.0515349475,2189,13.142922639,4383
LA,2020,7,8,11.96440857,2173,22.7415326522,2251,17.4479769038,4424
LA,2020,7,9,10.76016209,2159,21.146452671,2134,15.9230654443,4293
LA,2020,7,10,13.30029413,2142,21.8228571429,2240,17.6568758618,4382
LA,2020,7,11,14.24596798,2118,24.6399863946,2205,19.5475665468,4323
LA,2020,7,12,11.96997613,2095,27.8767039627,2145,20.0171297152,4240
LA,2020,7,13,10.14864007,2206,22.4837853881,2190,16.2937647849,4396
LA,2020,7,14,9.39102451,2157,22.2426570916,2228,15.9208848046,4385
LA,2020,7,15,12.29507893,2091,21.8803569794,2185,17.193075314,4276
LA,2020,7,16,11.33892666,2059,20.6396383187,2046,15.9745554185,4105
LA,2020,7,17,12.83688017,1952,29.182188716,2056,21.2215993243,4008
LA,2020,7,18,9.898816094,1892,22.9422628108,1971,16.5539114807,3863
LA,2020,7,19,13.21342603,1941,28.1042650722,2007,20.7833130507,3948
LA,2020,7,20,12.93311394,2097,22.4750479846,2084,17.6892465755,4181
LA,2020,7,21,8.863249064,2136,21.1575905882,2125,14.9945505751,4261
LA,2020,7,22,12.2344686,2117,20.7687511191,2234,16.616354867,4351
LA,2020,7,23,12.98043846,2121,25.7496456876,2145,19.4009610815,4266
LA,2020,7,24,12.87288708,2054,17.2452812645,2151,15.1095148781,4205
LA,2020,7,25,11.56918777,1933,19.9232278794,2023,15.8412360868,3956
LA,2020,7,26,12.68974233,1940,24.5217364658,1958,18.6330580093,3898
LA,2020,7,27,10.74619156,2098,21.8964433498,2030,16.2294791407,4128
LA,2020,7,28,9.310734355,2097,23.0377122642,2120,16.2116575628,4217
LA,2020,7,29,10.63863649,2083,22.0686530224,2101,16.3782313118,4184
LA,2020,7,30,11.11935246,2054,19.8677726433,2164,15.6076363094,4218
LA,2020,7,31,13.51319958,1919,26.0896358268,2032,19.9812629699,3951
MA,2020,1,1,19.99321195,2391,28.9267253377,2443,24.5080181573,4834
MA,2020,1,2,16.18958184,2463,24.9773461371,2291,20.4244930736,4754
MA,2020,1,3,16.49467805,2578,21.0546447639,2435,18.7096229828,5013
MA,2020,1,4,19.39179128,2663,16.9678814172,2766,18.1568429137,5429
MA,2020,1,5,17.58556853,2392,36.5847014028,2495,27.2853509154,4887
MA,2020,1,6,12.12874151,2503,26.0314025424,2360,18.8756631708,4863
MA,2020,1,7,13.71415772,2523,24.5736053883,2524,19.1449573861,5047
MA,2020,1,8,15.0306625,2566,19.7650356394,2385,17.3113088215,4951
MA,2020,1,9,13.25445801,2611,20.9371355196,2531,17.0360326457,5142
MA,2020,1,10,14.76648168,2504,16.6548915569,2582,15.7251671504,5086
MA,2020,1,11,16.47195703,2463,16.3625212121,2475,16.4171061492,4938
MA,2020,1,12,15.7940629,2545,16.5294083575,2417,16.1522511246,4962
MA,2020,1,13,14.2001215,2798,24.782634348,2661,19.3585876455,5459
MA,2020,1,14,15.44008685,2301,18.2610299489,2738,16.9728795082,5039
MA,2020,1,15,17.92714418,2213,10.7326521739,1840,14.6609548656,4053
MA,2020,1,16,18.91069633,2714,19.60435787,2554,19.2469931358,5268
MA,2020,1,17,17.80923078,2574,30.6927012591,2621,24.3092454336,5195
MA,2020,1,18,13.4572554,2474,14.7922025525,2429,14.1186028676,4903
MA,2020,1,19,17.72627692,2463,19.8951736672,2476,18.8135796829,4939
MA,2020,1,20,18.46346675,2550,26.3479604998,2481,22.3516458383,5031
MA,2020,1,21,15.88341506,2653,22.3308205128,2535,19.0337953266,5188
MA,2020,1,22,16.37374122,2705,20.402838835,2575,18.338689394,5280
MA,2020,1,23,15.19792231,2575,21.4644150641,2496,18.282356527,5071
MA,2020,1,24,17.2562469,2454,25.9303142627,2482,21.6178828794,4936
MA,2020,1,25,16.40624448,2479,16.3940188518,2334,16.400315825,4813
MA,2020,1,26,15.73711303,2494,22.5744861585,2637,19.2510777425,5131
MA,2020,1,27,12.06021391,2571,19.2438536155,2268,15.427127498,4839
MA,2020,1,28,13.20088579,2619,16.9247153168,2494,15.0172814168,5113
MA,2020,1,29,14.01764839,2764,20.2628499418,2579,17.0321299176,5343
MA,2020,1,30,14.78833333,2724,20.1678429848,2573,17.4014121184,5297
MA,2020,1,31,19.44746278,2688,20.6378922287,2728,20.0470734772,5416
MA,2020,2,1,17.21063588,2768,28.5478033554,2563,22.6612380634,5331
MA,2020,2,2,13.05133435,1851,17.8875601154,3119,16.08638227,4970
MA,2020,2,3,18.99893334,1603,13.6015737952,1328,16.5534562074,2931
MA,2020,2,4,10.73283834,2512,10.2688500663,2261,10.5130441882,4773
MA,2020,2,5,9.742637851,2593,18.7745708304,2866,14.4844440278,5459
MA,2020,2,6,19.52860626,1277,24.3470598364,2323,22.6378472761,3600
MA,2020,2,7,11.84974453,1370,8.0694354067,1045,10.2139585947,2415
MA,2020,2,8,16.80137328,2534,23.6887454324,2463,20.1961296561,4997
MA,2020,2,9,19.07224102,2365,23.3968181818,2508,21.2979827647,4873
MA,2020,2,10,11.38276747,2421,21.7808491418,2214,16.3496181327,4635
MA,2020,2,11,11.12208505,2446,22.5120518009,2471,16.8460240049,4917
MA,2020,2,12,14.66692374,2451,14.0075836081,2123,14.3608942035,4574
MA,2020,2,13,18.23195413,2840,28.7792812153,2699,23.3713720399,5539
MA,2020,2,14,17.93374565,2571,20.1910843819,2702,19.0904551614,5273
MA,2020,2,15,14.25680697,2305,18.7625104954,2382,16.5466695255,4687
MA,2020,2,16,15.68034501,2319,19.250992082,2147,17.3969100041,4466
MA,2020,2,17,16.91072708,2393,19.1315813118,2226,17.9810066903,4619
MA,2020,2,18,13.12939229,2633,21.2511885421,2339,16.9501649034,4972
MA,2020,2,19,13.19424138,2676,19.3006205165,2788,16.310014629,5464
MA,2020,2,20,17.59324577,2548,22.6683259912,2497,20.1051338398,5045
MA,2020,2,21,19.2381647,2452,26.5276028765,2503,22.9203975468,4955
MA,2020,2,22,15.95282506,2361,26.3115117503,2851,21.6190982284,5212
MA,2020,2,23,17.28751452,2410,24.2988048986,2368,20.7623440756,4778
MA,2020,2,24,13.76691318,2624,23.9699184672,2453,18.6965905425,5077
MA,2020,2,25,16.78787246,2806,19.6210109807,2641,18.1615311406,5447
MA,2020,2,26,20.72585763,2880,23.6037066667,2625,22.098128969,5505
MA,2020,2,27,22.95540558,3008,31.2979322389,2863,27.0236484389,5871
MA,2020,2,28,20.34654771,2943,27.8207220708,2936,24.0791852204,5879
MA,2020,2,29,21.66805126,2807,24.9423164983,2970,23.3513761272,5777
MA,2020,3,1,28.07470831,2623,43.2939478655,2647,35.7189829027,5270
MA,2020,3,2,20.48469381,2825,53.8988320356,2697,36.8044929397,5522
MA,2020,3,3,14.96380883,2951,19.6240434193,2948,17.2927411184,5899
MA,2020,3,4,17.01812965,2807,24.5046712538,2616,20.6295611152,5423
MA,2020,3,5,16.93682461,2828,21.0441681901,2735,18.9561639398,5563
MA,2020,3,6,19.21337431,2602,19.6017033384,2636,19.4087991513,5238
MA,2020,3,7,17.64742644,2448,17.479890644,2469,17.5633007779,4917
MA,2020,3,8,20.41737946,2427,25.9375713677,2347,23.1312232822,4774
MA,2020,3,9,15.04099965,2661,22.8141047297,2368,18.7011135551,5029
MA,2020,3,10,9.647877193,2916,16.735194085,2705,13.0585144805,5621
MA,2020,3,11,12.74247213,3224,17.0591479973,2946,14.8035624225,6170
MA,2020,3,12,13.52580492,3280,23.2401493486,3147,18.2824630679,6427
MA,2020,3,13,11.24482859,2947,17.2225196335,3056,14.287944337,6003
MA,2020,3,14,7.381339758,2926,13.3215950691,2677,10.2194735199,5603
MA,2020,3,15,10.53868887,3005,11.7035822436,2906,11.1113804863,5911
MA,2020,3,16,10.56537624,3322,11.434945243,2922,10.9723077946,6244
MA,2020,3,17,8.465017523,3428,15.0041601344,3572,11.8018485813,7000
MA,2020,3,18,5.610394861,3191,10.4756333333,3000,7.96796478783,6191
MA,2020,3,19,5.181858835,3287,6.56247469801,3063,5.84781574656,6350
MA,2020,3,20,4.307541861,3104,11.317493598,3124,7.82377327176,6228
MA,2020,3,21,4.849625412,2910,8.21641764497,2811,6.50389091923,5721
MA,2020,3,22,4.619007327,2871,11.8731508301,2831,8.22063487124,5702
MA,2020,3,23,4.613644306,2969,9.14301389384,2807,6.81481127848,5776
MA,2020,3,24,4.819608804,3042,10.3373964088,2896,7.51066857221,5938
MA,2020,3,25,4.530653161,3108,10.5112722298,2924,7.42974635683,6032
MA,2020,3,26,4.469394887,3074,9.73860989566,2971,7.05911164312,6045
MA,2020,3,27,3.883631843,2814,7.8343627451,2856,5.87362963072,5670
MA,2020,3,28,3.856745658,2784,8.49282217973,2615,6.10222446969,5399
MA,2020,3,29,3.554949999,2800,6.83274936525,2757,5.18116789584,5557
MA,2020,3,30,4.741748358,2877,7.79932890855,2712,6.22540526498,5589
MA,2020,3,31,4.076961084,2955,7.16705132872,2747,5.56564538815,5702
MA,2020,4,1,5.250857782,3031,9.52750704225,2840,7.31961674966,5871
MA,2020,4,2,4.204333099,2984,10.7757925978,2864,7.42264021331,5848
MA,2020,4,3,3.076308102,2733,13.7745438218,2784,8.47487403349,5517
MA,2020,4,4,5.666587539,2696,10.5748837209,2537,8.04616854675,5233
MA,2020,4,5,4.477193804,2580,7.7309429477,2524,6.08621865484,5104
MA,2020,4,6,3.885106766,2763,7.28090075727,2509,5.5012006818,5272
MA,2020,4,7,4.332607142,2823,12.2281129944,2655,8.15928987986,5478
MA,2020,4,8,4.009915482,2485,9.07367377478,2673,6.63407715641,5158
MA,2020,4,9,5.289779157,2445,11.7500973574,2157,8.31779009971,4602
MA,2020,4,10,4.194412232,2552,13.2609745426,2514,8.69368930439,5066
MA,2020,4,11,3.557439945,2414,7.23982323232,2376,5.38402505788,4790
MA,2020,4,12,4.433877001,2422,10.5330054875,2369,7.44970571831,4791
MA,2020,4,13,3.660508202,2617,10.4051928429,2515,6.96582423317,5132
MA,2020,4,14,3.493737318,2665,5.05377840909,2464,4.24318969633,5129
MA,2020,4,15,3.973754603,2722,9.31012563801,2547,6.55332131892,5269
MA,2020,4,16,4.6710538,2714,10.6113749032,2582,7.56718467017,5296
MA,2020,4,17,4.548495413,2632,10.0509391166,2513,7.2360835621,5145
MA,2020,4,18,3.277496037,2536,6.32430149961,2534,4.80029782048,5070
MA,2020,4,19,4.757223769,2471,7.15862337662,2310,5.91749005087,4781
MA,2020,4,20,3.788132731,2592,11.2039125,2400,7.3534114661,4992
MA,2020,4,21,5.552193321,2731,4.35075144509,2595,4.96681185874,5326
MA,2020,4,22,3.536331584,2696,9.78435294118,2465,6.52051539439,5161
MA,2020,4,23,3.695692357,2672,8.95071123202,2573,6.27360724078,5245
MA,2020,4,24,3.958422135,2383,8.98601440576,2499,6.53194796143,4882
MA,2020,4,25,3.939082413,2245,9.27600549702,2183,6.57018067235,4428
MA,2020,4,26,5.043232109,2206,6.02044474394,2226,5.53404332862,4432
MA,2020,4,27,3.370694336,2290,8.01379326047,2196,5.64359786657,4486
MA,2020,4,28,4.346838767,2382,8.90910291439,2196,6.53529050743,4578
MA,2020,4,29,3.584203205,2441,12.2218659658,2283,7.75858594907,4724
MA,2020,4,30,4.728855674,2508,10.2009923664,2358,7.38058159276,4866
MA,2020,5,1,4.675593666,2333,11.7577118644,2596,8.40559546009,4929
MA,2020,5,2,5.797854868,2205,9.51161121673,2104,7.61120909351,4309
MA,2020,5,3,4.508166971,2204,15.9930461394,2124,10.144461646,4328
MA,2020,5,4,4.85805675,2326,8.40129569644,2161,6.5645286384,4487
MA,2020,5,5,4.242896378,2403,11.9137151703,2261,7.96153301808,4664
MA,2020,5,6,4.429792106,2453,8.44070477009,2327,6.38238494477,4780
MA,2020,5,7,5.230712208,2429,14.9802475033,2303,9.97567835022,4732
MA,2020,5,8,4.1274333,2361,11.058576404,2297,7.54538858336,4658
MA,2020,5,9,3.963606116,2285,8.29479365079,2205,6.09061469378,4490
MA,2020,5,10,4.294697297,2197,8.88935879302,2121,6.55159332133,4318
MA,2020,5,11,5.573743797,2217,11.56999511,2045,8.45087517549,4262
MA,2020,5,12,4.51019306,2331,6.77496343693,2188,5.60674486012,4519
MA,2020,5,13,5.538915415,2176,12.139649753,2227,8.87751077516,4403
MA,2020,5,14,4.793946441,2278,11.4024505327,1971,7.85945869442,4249
MA,2020,5,15,7.912375279,2345,9.8556113627,2429,8.90108923948,4774
MA,2020,5,16,5.008947624,2138,13.8967381174,2146,9.46114146128,4284
MA,2020,5,17,4.888032575,2150,11.848666036,2114,8.33896576835,4264
MA,2020,5,18,4.801620561,2240,6.13110347985,2184,5.45794757157,4424
MA,2020,5,19,4.7636966,2294,6.81674916706,2101,5.74514448246,4395
MA,2020,5,20,5.32908092,2361,14.5064358736,2152,9.70525372305,4513
MA,2020,5,21,6.420757029,2338,13.2179882459,2212,9.72525712831,4550
MA,2020,5,22,7.18090109,2153,12.4386345201,2219,9.84945335013,4372
MA,2020,5,23,6.885502447,2070,9.07727952167,2007,7.96445672438,4077
MA,2020,5,24,8.742547706,2045,9.15686537506,2013,8.94807295682,4058
MA,2020,5,25,6.174963884,2077,11.6672754491,2004,8.87199705638,4081
MA,2020,5,26,5.890765773,2233,13.2522772749,2099,9.45766619832,4332
MA,2020,5,27,5.237938584,2280,10.9797088725,2164,8.03388613221,4444
MA,2020,5,28,5.077799032,2408,12.0878033378,2217,8.43805406899,4625
MA,2020,5,29,5.941712194,2307,11.0982256072,2429,8.5863851418,4736
MA,2020,5,30,5.848202476,2203,5.85813842482,2095,5.85304561532,4298
MA,2020,5,31,7.341815349,2242,10.6396470588,2210,8.97887915823,4452
MA,2020,6,1,5.548859068,2349,15.5792811839,2365,10.58109248,4714
MA,2020,6,2,4.054296228,2316,7.43897985426,2333,5.75282642806,4649
MA,2020,6,3,4.52787335,2290,13.9916077586,2320,9.29053361638,4610
MA,2020,6,4,7.419537837,2272,9.24109727985,2169,8.30919386752,4441
MA,2020,6,5,7.138437206,2182,11.150188764,2225,9.16388472509,4407
MA,2020,6,6,5.689624291,1943,12.1377908113,2046,8.99695663009,3989
MA,2020,6,7,5.309366395,1894,6.10530590146,1847,5.70233626093,3741
MA,2020,6,8,7.728579297,1999,13.9322830089,1901,10.7524871833,3900
MA,2020,6,9,6.405940499,2185,10.6941909308,2095,8.5049789697,4280
MA,2020,6,10,6.232082967,2194,8.94600280505,2139,7.57181860826,4333
MA,2020,6,11,7.240842324,2232,8.25941415052,2219,7.74864076998,4451
MA,2020,6,12,8.939437471,1991,13.2103099666,2097,11.1302446196,4088
MA,2020,6,13,9.276564589,1895,11.4259073775,1857,10.3403517847,3752
MA,2020,6,14,7.740583432,1937,12.29216,1875,9.97935732103,3812
MA,2020,6,15,6.230629195,2082,11.0408400402,1988,8.58018672825,4070
MA,2020,6,16,6.889458949,2144,8.34710948905,2055,7.60283638644,4199
MA,2020,6,17,5.168065566,2166,15.3176790005,2081,10.141304454,4247
MA,2020,6,18,8.219702962,2289,13.9203494253,2175,10.997235681,4464
MA,2020,6,19,6.192157212,2137,11.7427235772,2214,9.01655480626,4351
MA,2020,6,20,7.978939377,2093,16.0788586693,2059,11.9957346137,4152
MA,2020,6,21,8.490597723,2041,23.0330145218,1997,15.6825755207,4038
MA,2020,6,22,5.148811221,2103,18.4094673367,1990,11.5960884431,4093
MA,2020,6,23,8.81619465,2168,14.2796923805,2113,11.5128474658,4281
MA,2020,6,24,6.454596213,2167,11.9006719925,2128,9.1529080311,4295
MA,2020,6,25,6.289700651,2138,14.7305550329,2126,10.4982504671,4264
MA,2020,6,26,8.421112193,2077,13.1184156977,2064,10.7623907329,4141
MA,2020,6,27,7.001759695,2114,14.1264635958,2019,10.4822284044,4133
MA,2020,6,28,6.990402595,2136,17.6198410472,2139,12.3088514486,4275
MA,2020,6,29,6.78874221,2250,11.3534287077,2097,8.99075453704,4347
MA,2020,6,30,5.455243738,2195,9.88706040268,2235,7.69116027199,4430
MA,2020,7,1,8.736145895,2221,16.9720800736,2173,12.8091283643,4394
MA,2020,7,2,11.02511169,2195,14.3627004219,2133,12.6700000369,4328
MA,2020,7,3,11.25127166,2076,14.7930491963,2053,13.0122959472,4129
MA,2020,7,4,8.72141619,1963,13.6809387352,2024,11.2391171259,3987
MA,2020,7,5,12.73608803,1930,20.9819572193,1870,16.7939236573,3800
MA,2020,7,6,7.883543213,2128,16.8269064039,2030,12.2498316396,4158
MA,2020,7,7,6.656782316,2191,14.5490303624,2042,10.4640042651,4233
MA,2020,7,8,7.05189069,2232,12.8450723285,2143,9.88955657602,4375
MA,2020,7,9,9.596608453,2291,18.7646846011,2156,14.0414863876,4447
MA,2020,7,10,8.391806071,2093,15.0083853211,2180,11.7674538045,4273
MA,2020,7,11,9.276802241,1992,13.9737341451,1971,11.6128236346,3963
MA,2020,7,12,11.1008062,1997,17.8141065028,1953,14.4200658181,3950
MA,2020,7,13,6.314670006,2182,10.5448572835,2032,8.35447554653,4214
MA,2020,7,14,6.212767712,2204,12.9639241706,2110,9.51479370358,4314
MA,2020,7,15,7.292741151,2167,9.86351580934,2119,8.56373310178,4286
MA,2020,7,16,6.696888569,2163,13.0796327543,2015,9.77521062105,4178
MA,2020,7,17,9.431034375,1982,17.3132051282,2106,13.4916634372,4088
MA,2020,7,18,7.780042909,1865,17.5495045773,1857,12.6542745904,3722
MA,2020,7,19,9.202255952,1946,16.0261374284,1921,12.5921386301,3867
MA,2020,7,20,9.906629784,2166,16.51472167,2012,13.0888894476,4178
MA,2020,7,21,7.050834071,2206,14.6422160149,2148,10.7959623244,4354
MA,2020,7,22,8.485264972,2302,17.0910101476,2168,12.6591476433,4470
MA,2020,7,23,9.24589003,2309,13.9740859748,2303,11.6069124196,4612
MA,2020,7,24,8.777315993,2079,11.7515934066,2184,10.301083732,4263
MA,2020,7,25,9.151972163,2008,17.7259488692,2034,13.4665363937,4042
MA,2020,7,26,10.1744903,2060,16.0915283401,1976,13.0714345932,4036
MA,2020,7,27,10.41421265,2210,18.0849516441,2068,14.1222744171,4278
MA,2020,7,28,9.63422424,2256,10.8515419501,2205,10.2359246549,4461
MA,2020,7,29,7.467978315,2305,14.5618960924,2252,10.973684445,4557
MA,2020,7,30,7.974738517,2256,12.3671564195,2212,10.1493196272,4468
MA,2020,7,31,11.43854243,2072,17.4720199728,2203,14.5477239567,4275
MD,2020,1,1,18.8798342,3136,23.4723334449,2987,21.1202057898,6123
MD,2020,1,2,16.80910735,3148,19.9799459265,2774,18.2944005299,5922
MD,2020,1,3,13.24882885,3279,18.2586714824,3184,15.7169301871,6463
MD,2020,1,4,14.42261105,3198,17.2029265937,3106,15.7924809863,6304
MD,2020,1,5,16.59256883,2978,19.4722305683,3062,18.052423837,6040
MD,2020,1,6,10.59784996,3079,24.8479841897,2783,17.363138865,5862
MD,2020,1,7,8.929838324,3031,16.7683044637,3002,12.8302320504,6033
MD,2020,1,8,10.82703702,2943,18.0694597421,2869,14.4021421111,5812
MD,2020,1,9,13.30005401,2964,14.8476958363,2834,14.0565246784,5798
MD,2020,1,10,16.29820709,3023,16.350860177,2825,16.3236422765,5848
MD,2020,1,11,14.03016805,3154,18.8314118412,3074,16.3999534409,6228
MD,2020,1,12,16.36736629,2916,26.232182959,3028,21.3927136779,5944
MD,2020,1,13,11.34757405,2902,15.7645122397,2737,13.491422219,5639
MD,2020,1,14,11.56467548,2419,18.4061621622,2775,15.2198787035,5194
MD,2020,1,15,13.07505846,2311,13.9773591377,2041,13.4982192328,4352
MD,2020,1,16,15.84889739,2893,18.9099247271,2657,17.3143297566,5550
MD,2020,1,17,17.59697995,2937,21.5389040616,2856,19.5403832407,5793
MD,2020,1,18,13.4482768,2861,20.2764712349,2729,16.781754906,5590
MD,2020,1,19,15.18389961,2908,23.2165641569,2829,19.144925931,5737
MD,2020,1,20,12.56958377,2907,18.9763228863,2744,15.6805538877,5651
MD,2020,1,21,9.442141388,2928,14.1545369369,2775,11.7351271233,5703
MD,2020,1,22,11.30582731,2895,17.2525394495,2725,14.189242004,5620
MD,2020,1,23,11.98632606,2877,19.6774972355,2713,15.7190894588,5590
MD,2020,1,24,15.72299257,2817,18.0225948681,2767,16.8624982216,5584
MD,2020,1,25,14.67240937,2922,18.3600540332,2591,16.4055287827,5513
MD,2020,1,26,14.28256411,2964,19.5995740741,3240,17.0593391396,6204
MD,2020,1,27,9.47257321,2732,13.9671714398,2549,11.6419977295,5281
MD,2020,1,28,9.924084111,2877,14.4706278539,2628,12.0945322411,5505
MD,2020,1,29,10.54332994,2925,15.5727861771,2778,12.9932386594,5703
MD,2020,1,30,15.07788632,2990,14.3018100559,2685,14.7107031008,5675
MD,2020,1,31,13.83706695,2898,19.5081676689,2827,16.6374515321,5725
MD,2020,2,1,14.28091986,3033,22.8043688255,2733,18.3209104987,5766
MD,2020,2,2,14.1221481,2188,18.0593597464,3155,16.4470409962,5343
MD,2020,2,3,12.10098746,1823,11.2957489388,1649,11.7185455471,3472
MD,2020,2,4,7.853538388,2617,11.9094025157,2226,9.71774519129,4843
MD,2020,2,5,9.832441789,2834,20.5008983698,2883,15.2123893703,5717
MD,2020,2,6,15.93618628,1471,17.8068326693,2510,17.1156191956,3981
MD,2020,2,7,9.307339482,1526,9.17008264463,1089,9.25017975126,2615
MD,2020,2,8,13.42314111,2757,16.6557969349,2610,14.9951984424,5367
MD,2020,2,9,14.3857833,2547,17.3485076336,2620,15.8880743304,5167
MD,2020,2,10,10.73483981,2622,14.066214044,2364,12.3143361375,4986
MD,2020,2,11,10.4524319,2570,19.0714099526,2532,14.7298235953,5102
MD,2020,2,12,12.720704,2642,15.0966755437,2253,13.8142819138,4895
MD,2020,2,13,17.40765922,2999,19.7370931085,2728,18.517262092,5727
MD,2020,2,14,15.43641065,2839,20.074744734,2801,17.7399520985,5640
MD,2020,2,15,15.39767695,2600,18.622731668,2482,16.9727627056,5082
MD,2020,2,16,18.41367867,2645,24.4601037924,2505,21.3547068121,5150
MD,2020,2,17,15.55937068,2765,20.6745729606,2611,18.0437072043,5376
MD,2020,2,18,11.4899861,2879,18.0731302044,2642,14.640260819,5521
MD,2020,2,19,10.8368545,2893,16.0046993396,2877,13.413611797,5770
MD,2020,2,20,13.80610799,2798,15.6988658265,2698,14.7352674956,5496
MD,2020,2,21,15.56685497,2709,20.6334407319,2514,18.0055677032,5223
MD,2020,2,22,13.12212344,2722,17.1680534234,3257,15.3261030279,5979
MD,2020,2,23,16.87515702,2707,19.1923196071,2647,18.0207545859,5354
MD,2020,2,24,12.70655342,2765,19.1101932939,2535,15.769426454,5300
MD,2020,2,25,11.30552669,2886,16.0412094185,2803,13.6388222934,5689
MD,2020,2,26,14.07793909,2921,16.5885426584,2731,15.2910421235,5652
MD,2020,2,27,13.51822986,2932,18.2824295252,2696,15.8004406449,5628
MD,2020,2,28,15.65608801,2863,20.2044892766,2751,17.8849180571,5614
MD,2020,2,29,16.20301443,2634,18.6832357357,2664,17.450147227,5298
MD,2020,3,1,18.68337527,2622,24.0204911993,2443,21.2576248683,5065
MD,2020,3,2,14.05753856,2791,19.4829072006,2597,16.6725501338,5388
MD,2020,3,3,12.24156039,2807,19.6992815982,2603,15.8298133114,5410
MD,2020,3,4,14.47354972,2758,15.3707328072,2661,14.9141114833,5419
MD,2020,3,5,16.89334504,2852,21.8576294074,2666,19.2918195096,5518
MD,2020,3,6,15.06675169,2706,24.5730029261,2734,19.8443419252,5440
MD,2020,3,7,13.2966056,2619,19.3095343236,2491,16.2277612654,5110
MD,2020,3,8,16.06034139,2607,19.275468241,2456,17.6199604985,5063
MD,2020,3,9,13.3266419,2689,17.4624801902,2524,15.3291080125,5213
MD,2020,3,10,11.60417325,2909,13.9374434389,2652,12.7168926424,5561
MD,2020,3,11,11.08609763,3216,18.0349307479,2888,14.3738155272,6104
MD,2020,3,12,10.99851947,3215,17.4982835101,3111,14.194973142,6326
MD,2020,3,13,12.56793957,2912,19.8793650255,2945,16.2442496206,5857
MD,2020,3,14,11.15981423,2853,11.3300755572,2647,11.2417563633,5500
MD,2020,3,15,12.02251498,3002,20.0672372583,2845,15.9368701847,5847
MD,2020,3,16,10.08016163,3278,15.6531780472,3134,12.8040907397,6412
MD,2020,3,17,6.682903711,3375,13.4663730408,3190,9.97906017131,6565
MD,2020,3,18,5.945553904,3331,11.7553863418,3119,8.75499070608,6450
MD,2020,3,19,6.96820977,3385,10.4319820932,3239,8.66192331997,6624
MD,2020,3,20,6.335633055,3254,12.2403650075,3315,9.31541482128,6569
MD,2020,3,21,5.413100599,3122,9.74065600522,3064,7.55659069998,6186
MD,2020,3,22,7.286922617,3100,11.9662852349,2980,9.58042600538,6080
MD,2020,3,23,5.75173875,3215,8.67337837838,3108,7.18783806441,6323
MD,2020,3,24,4.968843385,3320,7.23462542742,3217,6.08388405051,6537
MD,2020,3,25,4.782144353,3339,8.19967324291,3244,6.46624942954,6583
MD,2020,3,26,5.016889929,3315,11.2148674476,3244,8.08233269014,6559
MD,2020,3,27,5.366219352,3100,8.4667566709,3148,6.92839788592,6248
MD,2020,3,28,4.978434695,3009,6.04333791209,2912,5.50216348543,5921
MD,2020,3,29,4.639068043,3101,7.33915520629,3054,5.97880259973,6155
MD,2020,3,30,3.24897901,3242,7.17975997506,3208,5.20400929464,6450
MD,2020,3,31,4.068521079,3293,10.4753078419,3086,7.16796361705,6379
MD,2020,4,1,3.110382124,3245,10.0633167547,3217,6.57178582364,6462
MD,2020,4,2,3.448472573,3136,8.82386693017,3036,6.09262313495,6172
MD,2020,4,3,4.524579652,2950,8.88353670473,3065,6.74572734387,6015
MD,2020,4,4,3.759229965,2909,4.95194677871,2856,4.35010580541,5765
MD,2020,4,5,3.934370178,2977,7.23786497601,2918,5.56958609328,5895
MD,2020,4,6,3.526722381,3051,7.19716142271,2924,5.32293388861,5975
MD,2020,4,7,3.647442025,3104,7.5481304197,2883,5.52579255814,5987
MD,2020,4,8,3.0563937,2784,7.55428197579,3057,5.41045027577,5841
MD,2020,4,9,4.025577205,2668,5.11269758065,2480,4.54928709847,5148
MD,2020,4,10,3.695129846,2811,9.14645184649,2762,6.39682576657,5573
MD,2020,4,11,3.55979527,2784,6.71132137628,2732,5.12070341401,5516
MD,2020,4,12,4.171909372,2802,9.81864777618,2788,6.98820752421,5590
MD,2020,4,13,3.28587163,2851,7.89423759507,2761,5.55310228388,5612
MD,2020,4,14,3.670037337,2947,6.2532649388,2778,4.92352314972,5725
MD,2020,4,15,3.494928094,2920,5.75089174185,2882,4.61552223966,5802
MD,2020,4,16,2.892494813,2890,7.58786021505,2790,5.19884507211,5680
MD,2020,4,17,3.934992884,2804,6.75860195581,2761,5.3358885978,5565
MD,2020,4,18,3.544085978,2768,6.78367505551,2702,5.1443363779,5470
MD,2020,4,19,3.72594595,2701,5.39346632504,2732,4.56446346603,5433
MD,2020,4,20,3.659160775,2824,7.96302129222,2724,5.77230353796,5548
MD,2020,4,21,4.104867904,2839,8.82616300707,2687,6.40058269625,5526
MD,2020,4,22,4.496092284,2948,6.71905951506,2722,5.563273378,5670
MD,2020,4,23,3.891069965,3075,9.59058960693,3002,6.70659702853,6077
MD,2020,4,24,4.404800433,2806,6.73065963958,2941,5.59504785366,5747
MD,2020,4,25,4.70085072,2586,5.83120327103,2568,5.2640531552,5154
MD,2020,4,26,4.212506992,2501,7.41333065165,2486,5.80810507058,4987
MD,2020,4,27,3.814218772,2560,5.92008173273,2447,4.84338726909,5007
MD,2020,4,28,3.923690832,2620,9.0559047619,2625,6.4922440381,5245
MD,2020,4,29,4.077881128,2709,7.16912720157,2555,5.57828646956,5264
MD,2020,4,30,3.695012973,2699,8.25497021593,2686,5.9694874678,5385
MD,2020,5,1,4.775433933,2604,14.3006296166,2843,9.7470020124,5447
MD,2020,5,2,5.054078082,2484,9.42543373494,2490,7.24239243178,4974
MD,2020,5,3,3.858441351,2515,5.8697416349,2361,4.83232977805,4876
MD,2020,5,4,4.272211261,2632,6.75584890966,2568,5.49874616134,5200
MD,2020,5,5,4.483291939,2579,13.1152677165,2540,8.76639771648,5119
MD,2020,5,6,5.124311058,2707,8.59295219885,2615,6.82865088952,5322
MD,2020,5,7,5.453758327,2698,9.55922112462,2632,7.48107128823,5330
MD,2020,5,8,5.406721178,2568,10.8016329705,2572,8.10627626169,5140
MD,2020,5,9,4.519535882,2564,8.71139321357,2505,6.59106924471,5069
MD,2020,5,10,4.692800971,2442,8.84087008821,2494,6.78868516434,4936
MD,2020,5,11,4.959107356,2543,7.73057748234,2407,6.30676969824,4950
MD,2020,5,12,4.464097655,2621,9.48561151079,2502,6.91653327225,5123
MD,2020,5,13,4.739415129,2445,7.22048809524,2520,5.99869083392,4965
MD,2020,5,14,5.292997235,2499,8.41856329391,2283,6.78519031582,4782
MD,2020,5,15,6.062372952,2558,11.1326355707,2637,8.63605582507,5195
MD,2020,5,16,6.135848458,2428,9.91755646817,2435,8.02942423525,4863
MD,2020,5,17,5.742353186,2469,9.84890612245,2450,7.78769872255,4919
MD,2020,5,18,4.812882993,2598,9.11916058394,2466,6.9098973175,5064
MD,2020,5,19,4.750756855,2550,10.8605219207,2395,7.70988472806,4945
MD,2020,5,20,5.304414679,2648,10.747555205,2536,7.96718558449,5184
MD,2020,5,21,6.690982944,2635,11.2090293542,2555,8.91518498217,5190
MD,2020,5,22,7.96120146,2472,10.2459337232,2565,9.12465952137,5037
MD,2020,5,23,6.491551006,2392,11.1284142673,2327,8.77804831667,4719
MD,2020,5,24,7.44923613,2422,8.53006714226,2383,7.98526532921,4805
MD,2020,5,25,7.227006951,2449,11.611206823,2345,9.37155194472,4794
MD,2020,5,26,6.447544151,2549,16.6889419935,2448,11.4647428539,4997
MD,2020,5,27,5.721613985,2627,7.23485873458,2513,6.46145524097,5140
MD,2020,5,28,6.10885518,2734,15.2978390631,2647,10.6290633827,5381
MD,2020,5,29,8.26982424,2674,16.8690243018,2757,12.6351334962,5431
MD,2020,5,30,6.570223524,2550,11.7415295527,2504,9.13234269612,5054
MD,2020,5,31,8.0404102,2560,13.8290070367,2558,10.9335775912,5118
MD,2020,6,1,5.994810738,2800,18.8575708215,2824,12.4536362138,5624
MD,2020,6,2,5.515355337,2786,9.75483020231,2768,7.62822289681,5554
MD,2020,6,3,5.784150612,2696,9.87382823872,2748,7.84852131704,5444
MD,2020,6,4,5.616117057,2632,9.34290816327,2548,7.44929538495,5180
MD,2020,6,5,7.426055469,2487,13.550719312,2558,10.5314846286,5045
MD,2020,6,6,6.190693194,2366,11.161552901,2344,8.66451382102,4710
MD,2020,6,7,8.08543074,2252,9.90437472576,2279,9.00032223052,4531
MD,2020,6,8,7.106551999,2355,10.5262455357,2240,8.77360608436,4595
MD,2020,6,9,5.836209662,2480,10.069433416,2418,7.92602898362,4898
MD,2020,6,10,6.525764782,2517,10.1966803447,2437,8.33158255073,4954
MD,2020,6,11,6.18921804,2481,12.3653199052,2532,9.30868540938,5013
MD,2020,6,12,8.875888125,2359,13.7325689223,2394,11.3221102644,4753
MD,2020,6,13,7.898839567,2275,11.9982008368,2151,9.89109580093,4426
MD,2020,6,14,10.29027947,2290,12.6507302143,2287,11.469731262,4577
MD,2020,6,15,6.169752131,2380,17.6857700651,2305,11.8355837933,4685
MD,2020,6,16,5.524519434,2445,11.5914180399,2306,8.46921911516,4751
MD,2020,6,17,6.823702369,2466,9.09398708636,2478,7.96159992758,4944
MD,2020,6,18,10.09014026,2566,12.9798251322,2459,11.5042168969,5025
MD,2020,6,19,9.325817812,2415,11.3039493471,2527,10.3372986677,4942
MD,2020,6,20,10.14546864,2326,16.2136319719,2277,13.1472518046,4603
MD,2020,6,21,10.92917551,2353,12.1160844948,2296,11.5153538342,4649
MD,2020,6,22,7.75292849,2404,15.5227081507,2282,11.5366752219,4686
MD,2020,6,23,7.943549816,2448,15.5088232882,2439,11.7192203703,4887
MD,2020,6,24,7.250298335,2380,12.0321403354,2266,9.58255274156,4646
MD,2020,6,25,9.534249469,2365,11.5022941176,2380,10.5213825067,4745
MD,2020,6,26,11.52927715,2241,13.4766711651,2223,12.4990479599,4464
MD,2020,6,27,8.941044978,2268,10.6105148691,2253,9.77301039817,4521
MD,2020,6,28,9.47748837,2353,12.831410602,2226,11.1079384439,4579
MD,2020,6,29,9.919521905,2489,14.0818922359,2357,11.944017751,4846
MD,2020,6,30,7.881285335,2334,11.4082198078,2393,9.66676326886,4727
MD,2020,7,1,10.63490854,2351,16.9410411419,2382,13.8086266591,4733
MD,2020,7,2,10.2123458,2383,18.9846873652,2319,14.5388154065,4702
MD,2020,7,3,10.62426672,2407,15.4671857329,2299,12.9901551201,4706
MD,2020,7,4,8.649352419,2270,16.6262930274,2266,12.6343055536,4536
MD,2020,7,5,12.18128448,2320,16.4175314392,2147,14.2173763138,4467
MD,2020,7,6,8.384651366,2395,16.3411545139,2304,12.285860826,4699
MD,2020,7,7,8.326074484,2471,11.5093993862,2281,9.85409723274,4752
MD,2020,7,8,7.648885244,2431,16.0060944749,2371,11.7752790563,4802
MD,2020,7,9,8.793234227,2455,15.1591039125,2377,11.9247889129,4832
MD,2020,7,10,9.314427028,2356,13.07170814,2371,11.1990289989,4727
MD,2020,7,11,10.44067209,2336,10.9329269366,2272,10.6833810769,4608
MD,2020,7,12,9.440606205,2359,18.7228826087,2300,14.0229706026,4659
MD,2020,7,13,9.060919878,2446,12.1710941371,2422,10.6083401852,4868
MD,2020,7,14,7.544045387,2425,9.51781887755,2352,8.51585096577,4777
MD,2020,7,15,8.463935602,2485,12.2250512505,2439,10.3269252581,4924
MD,2020,7,16,8.603783355,2363,15.8475203426,2335,12.2040655743,4698
MD,2020,7,17,9.767874436,2357,16.9445508727,2349,13.3501126319,4706
MD,2020,7,18,9.364245999,2301,12.1965969751,2248,10.7639217506,4549
MD,2020,7,19,10.11175806,2389,12.1668819599,2245,11.1073888661,4634
MD,2020,7,20,7.386057728,2496,10.1217581047,2406,8.72879438782,4902
MD,2020,7,21,6.943422393,2583,14.9377852349,2384,10.7804590379,4967
MD,2020,7,22,8.106033948,2592,13.3812294754,2497,10.6943937892,5089
MD,2020,7,23,10.10899103,2547,12.8016176471,2516,11.4470610613,5063
MD,2020,7,24,8.878993159,2334,13.058557296,2426,11.0091659733,4760
MD,2020,7,25,11.18502777,2339,15.0775120667,2279,13.1059830996,4618
MD,2020,7,26,10.787056,2286,14.9915432099,2268,12.8809903417,4554
MD,2020,7,27,9.579755899,2417,19.5110602822,2339,14.4639697241,4756
MD,2020,7,28,7.85690842,2468,10.2298259762,2356,9.01582089149,4824
MD,2020,7,29,9.240792345,2499,13.500666389,2401,11.3281306266,4900
MD,2020,7,30,10.00680807,2475,17.2899473044,2467,13.6424827951,4942
MD,2020,7,31,12.57785936,2303,13.1224264706,2312,12.8506739125,4615
ME,2020,1,1,13.17914784,176,61.0594210526,190,38.0350273766,366
ME,2020,1,2,18.63970416,169,38.4512865497,171,28.6037647148,340
ME,2020,1,3,16.44514115,177,32.505625,176,24.4526345143,353
ME,2020,1,4,26.08274275,175,38.2419270833,192,32.4439509026,367
ME,2020,1,5,20.96248295,149,25.8865243902,164,23.5424918835,313
ME,2020,1,6,11.81549699,171,47.7166233766,154,28.827107647,325
ME,2020,1,7,17.82809219,173,25.3517741935,186,21.7261558464,359
ME,2020,1,8,16.30763942,161,53.2738983051,177,35.6657099012,338
ME,2020,1,9,14.75312154,173,43.2432967033,182,29.3593521871,355
ME,2020,1,10,34.37317891,151,24.9999444444,180,29.2759517082,331
ME,2020,1,11,17.45956524,161,16.9423493976,166,17.1970030692,327
ME,2020,1,12,27.59052323,153,37.1846783626,171,32.6541051055,324
ME,2020,1,13,12.51072287,166,30.7913294798,173,21.8397640012,339
ME,2020,1,14,18.44400022,135,46.8337967914,187,34.9312423283,322
ME,2020,1,15,8.039705904,136,32.55112,125,19.7788889002,261
ME,2020,1,16,24.35511849,168,21.7756470588,170,23.0577512021,338
ME,2020,1,17,10.46116976,171,28.201047619,210,20.2390551941,381
ME,2020,1,18,8.369565234,161,18.0200529101,189,13.5808285791,350
ME,2020,1,19,17.15027918,179,19.2087640449,178,18.1766385804,357
ME,2020,1,20,12.04869555,161,47.1707909605,177,30.4410354543,338
ME,2020,1,21,18.51420414,176,27.3451933702,181,22.9915404164,357
ME,2020,1,22,19.20415347,183,42.5801621622,185,30.9556795788,368
ME,2020,1,23,14.57642857,182,38.022259887,177,26.1360724227,359
ME,2020,1,24,16.80871342,171,54.6554347826,184,36.4250422389,355
ME,2020,1,25,16.00690072,171,27.2202366864,169,21.5805883033,340
ME,2020,1,26,22.87754027,187,18.4792307692,182,20.7081843645,369
ME,2020,1,27,7.320650972,169,34.7795505618,178,21.4061960065,347
ME,2020,1,28,6.818285761,175,65.4840223464,179,36.4825988931,354
ME,2020,1,29,20.83624313,181,44.9197883598,189,33.138378396,370
ME,2020,1,30,26.73653374,176,25.4530107527,186,26.0770440283,362
ME,2020,1,31,17.64424423,172,51.6013658537,205,36.1089920625,377
ME,2020,2,1,25.59120899,182,61.4062702703,185,43.6451227144,367
ME,2020,2,2,24.58458357,120,25.8255288462,208,25.3715244768,328
ME,2020,2,3,6.451702171,94,19.8294318182,88,12.9200549674,182
ME,2020,2,4,13.23594111,170,28.0850649351,154,20.2938579898,324
ME,2020,2,5,27.07810777,185,49.5018055556,216,39.1567080734,401
ME,2020,2,6,10.82978944,95,25.0806741573,178,20.1215750799,273
ME,2020,2,7,20.97076953,104,8.54633802817,71,15.9300001778,175
ME,2020,2,8,29.36898447,197,45.8511059908,217,38.0081641077,414
ME,2020,2,9,28.7201849,162,37.2138461538,182,33.2139242843,344
ME,2020,2,10,21.01113206,159,38.9309868421,152,29.7693890596,311
ME,2020,2,11,22.1056687,187,27.3440703518,199,24.8062954583,386
ME,2020,2,12,15.83390534,169,33.3999393939,165,24.5117365343,334
ME,2020,2,13,22.81709218,196,48.1428358209,201,35.6394460133,397
ME,2020,2,14,21.36985081,201,27.1948898678,227,24.4592990954,428
ME,2020,2,15,22.36758831,170,32.1321717172,198,27.6213587302,368
ME,2020,2,16,31.41235288,170,17.5960693642,173,24.4437900571,343
ME,2020,2,17,17.4115255,177,25.4707246377,207,21.7559375352,384
ME,2020,2,18,18.94899503,199,38.2276470588,187,28.2886528782,386
ME,2020,2,19,15.9997982,198,21.1377314815,216,18.6804590425,414
ME,2020,2,20,35.65316051,193,26.9041624365,197,31.2337948165,390
ME,2020,2,21,23.84458325,192,27.2803414634,205,25.6187153249,397
ME,2020,2,22,18.60632637,196,28.6133707865,267,24.3771273618,463
ME,2020,2,23,16.904759,166,32.4623655914,186,25.1255397557,352
ME,2020,2,24,16.91094467,180,16.7928813559,177,16.8524090773,357
ME,2020,2,25,12.73152167,184,26.4435748792,207,19.9908439572,391
ME,2020,2,26,17.77432586,178,31.4619047619,189,24.8232425152,367
ME,2020,2,27,12.00462862,175,38.9240860215,186,25.8744875582,361
ME,2020,2,28,25.77441346,179,45.7988557214,201,36.3662894983,380
ME,2020,2,29,15.54374989,152,34.3340182648,219,26.6355794698,371
ME,2020,3,1,30.17418602,172,28.0357594937,158,29.1503333195,330
ME,2020,3,2,16.08835067,194,28.5868983957,187,22.2228084776,381
ME,2020,3,3,13.46004893,204,28.519539749,239,21.5846952183,443
ME,2020,3,4,14.22356746,185,29.4523350254,197,22.0771465448,382
ME,2020,3,5,33.23098887,182,32.0979787234,188,32.6552972279,370
ME,2020,3,6,31.16548029,177,52.767047619,210,42.8872610112,387
ME,2020,3,7,16.84208584,187,25.8993617021,188,21.3828001389,375
ME,2020,3,8,40.98091481,164,26.6055747126,174,33.5805918013,338
ME,2020,3,9,22.972938,177,26.3882681564,179,24.6901967022,356
ME,2020,3,10,14.46142863,189,26.9878421053,190,20.7411609791,379
ME,2020,3,11,19.50504745,210,22.9337339056,233,21.3083972111,443
ME,2020,3,12,11.17270153,211,40.525426009,223,26.2548618038,434
ME,2020,3,13,15.35032589,215,34.989875,240,25.7096484975,455
ME,2020,3,14,14.84615406,208,40.4879512195,205,27.5739226259,413
ME,2020,3,15,30.00005109,193,35.893215859,227,33.1851663342,420
ME,2020,3,16,12.93490979,222,34.5770506912,217,23.6327334246,439
ME,2020,3,17,8.482640705,231,19.8861276596,235,14.2333261864,466
ME,2020,3,18,17.22181838,220,32.8596313364,217,24.9870481547,437
ME,2020,3,19,4.444285789,224,20.251563981,211,12.1117241764,435
ME,2020,3,20,9.970386334,233,33.1942241379,232,21.5573333674,465
ME,2020,3,21,10.18075562,225,15.0760287081,209,12.5381567154,434
ME,2020,3,22,5.185956354,183,13.0434010152,197,9.25942108627,380
ME,2020,3,23,5.982070733,198,33.2138421053,190,19.3172165081,388
ME,2020,3,24,12.18909074,231,18.70657277,213,15.3157206327,444
ME,2020,3,25,4.959383332,227,14.8406403941,203,9.62425585201,430
ME,2020,3,26,2.995574471,235,23.5275111111,225,13.0383695667,460
ME,2020,3,27,5.391932324,207,15.5046606335,221,10.6136915679,428
ME,2020,3,28,7.46779507,195,28.0721989529,191,17.6632384421,386
ME,2020,3,29,14.07492492,199,20.4911004785,209,17.3616423017,408
ME,2020,3,30,8.260144181,208,27.2697285068,221,18.0529603488,429
ME,2020,3,31,3.861863653,220,12.7486842105,228,8.38462054388,448
ME,2020,4,1,4.912825903,230,13.6673303167,221,9.20272717891,451
ME,2020,4,2,7.426226364,212,12.7221904762,210,10.0616587421,422
ME,2020,4,3,4.436057122,175,27.6346534653,202,16.8660742609,377
ME,2020,4,4,10.66868434,190,27.5883695652,184,18.9928075524,374
ME,2020,4,5,10.39244912,196,29.1069189189,185,19.4795276313,381
ME,2020,4,6,2.970095745,209,23.8720855615,187,12.840479825,396
ME,2020,4,7,4.433495529,226,32.0242857143,203,17.4892773649,429
ME,2020,4,8,14.39842374,203,19.2515454545,220,16.9225059556,423
ME,2020,4,9,4.664555612,180,11.8664795918,196,8.41875002702,376
ME,2020,4,10,9.157197961,182,24.801042654,211,17.5563105061,393
ME,2020,4,11,17.7520003,190,14.8394767442,172,16.3681493287,362
ME,2020,4,12,4.507710921,166,10.0425280899,178,7.3716570142,344
ME,2020,4,13,5.418314538,178,19.7405882353,170,12.414827551,348
ME,2020,4,14,3.903833347,180,28.3760344828,174,15.9325423798,354
ME,2020,4,15,8.904810895,185,15.93,183,12.3983152597,368
ME,2020,4,16,16.28555001,200,21.0377595628,183,18.5561879948,383
ME,2020,4,17,3.985079373,189,24.2117368421,190,14.1250923522,379
ME,2020,4,18,18.66928135,167,16.2236458333,192,17.3613091517,359
ME,2020,4,19,3.549350633,154,27.3788028169,142,14.9810472888,296
ME,2020,4,20,4.448423868,184,50.0693063584,173,26.5560223857,357
ME,2020,4,21,8.399204139,201,16.2972864322,199,12.3285000798,400
ME,2020,4,22,13.67677422,186,40.9593157895,190,27.4631649067,376
ME,2020,4,23,3.968556152,187,42.6833510638,188,23.3775733345,375
ME,2020,4,24,11.18335389,161,23.8951741294,201,18.2415745201,362
ME,2020,4,25,9.490062025,162,20.1857062147,177,15.0745134161,339
ME,2020,4,26,10.82277427,155,32.9652071006,169,22.3723765798,324
ME,2020,4,27,14.93071412,168,14.3386982249,169,14.6338278106,337
ME,2020,4,28,14.64164633,164,6.87644578313,166,10.7355151458,330
ME,2020,4,29,13.44937138,175,12.5914130435,184,13.0096378593,359
ME,2020,4,30,5.988333366,192,15.0146700508,197,10.5595115842,389
ME,2020,5,1,7.560179757,167,27.6296858639,191,18.2676536855,358
ME,2020,5,2,7.513718039,156,30.9386792453,159,19.3377460765,315
ME,2020,5,3,12.18575419,179,29.1319298246,171,20.4651714286,350
ME,2020,5,4,15.45375586,213,45.8766839378,193,29.915886695,406
ME,2020,5,5,12.89423033,182,10.5982446809,188,11.7276214056,370
ME,2020,5,6,4.20263476,167,37.394260355,169,20.8972321575,336
ME,2020,5,7,11.68472394,163,17.3510067114,149,14.3907371866,312
ME,2020,5,8,2.200723656,152,35.2276969697,165,19.3914195448,317
ME,2020,5,9,14.1385208,169,17.1807608696,184,15.7242776635,353
ME,2020,5,10,7.917500088,160,11.0725766871,163,9.50969044607,323
ME,2020,5,11,3.015056807,176,18.0824,175,10.5272649517,351
ME,2020,5,12,4.384867732,189,18.8657803468,173,11.3053038711,362
ME,2020,5,13,12.42029935,167,13.9727222222,180,13.2255907535,347
ME,2020,5,14,24.33684861,165,28.5364137931,145,26.3011613569,310
ME,2020,5,15,12.33558659,179,35.5205347594,187,24.1814480864,366
ME,2020,5,16,14.60485574,173,27.9248205128,195,21.6629892473,368
ME,2020,5,17,3.825723706,152,16.2394339623,159,10.1722829688,311
ME,2020,5,18,7.263028619,175,13.4236094675,169,10.2895930475,344
ME,2020,5,19,5.206666647,180,14.1960465116,172,9.5992045354,352
ME,2020,5,20,4.975053715,186,27.4412209302,172,15.7688547234,358
ME,2020,5,21,10.434599,187,33.9488505747,174,21.7683379861,361
ME,2020,5,22,8.734197621,162,40.5801507538,199,26.2891690155,361
ME,2020,5,23,8.695541354,157,15.9923780488,164,12.4235202261,321
ME,2020,5,24,5.265789433,152,15.0058219178,146,10.0377516571,298
ME,2020,5,25,14.62660688,168,49.0812280702,171,32.0063715512,339
ME,2020,5,26,7.986497114,177,25.3693939394,165,16.3729824245,342
ME,2020,5,27,3.676886266,167,21.3075956284,183,12.8952285898,350
ME,2020,5,28,10.84383412,193,15.7222346369,179,13.1912365192,372
ME,2020,5,29,18.51292094,178,21.0747395833,192,19.8422971009,370
ME,2020,5,30,5.002544401,169,16.4157591623,191,11.0578888994,360
ME,2020,5,31,10.23124982,168,12.2639285714,168,11.2475891957,336
ME,2020,6,1,20.13671732,198,23.2713596491,228,21.8144132145,426
ME,2020,6,2,4.643675722,185,29.0520873786,206,17.5033504055,391
ME,2020,6,3,13.02597878,189,20.8329468599,207,17.1068939127,396
ME,2020,6,4,20.33625038,200,17.3976190476,189,18.9084834859,389
ME,2020,6,5,7.690000024,168,20.8771363636,220,15.1672422784,388
ME,2020,6,6,2.70754286,175,25.0818539326,178,13.9897733725,353
ME,2020,6,7,5.513653891,156,19.3933510638,188,13.0990697878,344
ME,2020,6,8,3.744109542,146,22.5586338798,183,14.2093312861,329
ME,2020,6,9,8.731366387,161,15.7641216216,148,12.0998057874,309
ME,2020,6,10,17.59821238,179,30.0728125,160,23.4859292508,339
ME,2020,6,11,5.60454544,143,15.4713953488,172,10.9921587236,315
ME,2020,6,12,15.41025466,157,27.1520915033,153,21.2054192955,310
ME,2020,6,13,12.88602562,156,22.9197297297,148,17.7708552524,304
ME,2020,6,14,8.965696182,158,20.7667032967,182,15.2827058728,340
ME,2020,6,15,3.877125002,160,17.0747777778,180,10.864117648,340
ME,2020,6,16,6.972138651,173,30.8971186441,177,19.0713428189,350
ME,2020,6,17,7.75191252,183,20.4956395349,172,13.9263380033,355
ME,2020,6,18,7.478121562,181,14.9653614458,166,11.0599135525,347
ME,2020,6,19,8.123699398,173,34.9103141361,191,22.1793131754,364
ME,2020,6,20,23.59862103,174,37.2933502538,197,30.8704853348,371
ME,2020,6,21,24.61954007,174,42.3653763441,186,33.7882221449,360
ME,2020,6,22,7.523806829,176,23.3519337017,181,15.5487114899,357
ME,2020,6,23,4.473820303,178,44.5542934783,184,24.8462155081,362
ME,2020,6,24,7.169112384,169,23.6933673469,196,16.0424109394,365
ME,2020,6,25,12.18808297,193,25.5815183246,191,18.8499219094,384
ME,2020,6,26,11.56633152,169,15.0589017341,173,13.3330410143,342
ME,2020,6,27,21.45810132,158,15.8119125683,183,18.4280352157,341
ME,2020,6,28,11.08856249,160,23.6074698795,166,17.463220854,326
ME,2020,6,29,7.447160465,162,14.7620467836,171,11.2034534394,333
ME,2020,6,30,4.914121601,148,36.4186315789,190,22.6237573874,338
ME,2020,7,1,10.3492618,149,32.5432142857,168,22.1113564927,317
ME,2020,7,2,15.41457457,188,18.342642487,193,16.8978215726,381
ME,2020,7,3,11.09677604,183,26.6423076923,195,19.1162963368,378
ME,2020,7,4,21.99730059,163,47.8581460674,178,35.4965102527,341
ME,2020,7,5,19.57303779,158,15.8328378378,148,17.7640521922,306
ME,2020,7,6,8.175722545,173,40.3962569832,179,24.5605965917,352
ME,2020,7,7,11.57397655,171,24.3238636364,176,18.0407780693,347
ME,2020,7,8,22.04714275,196,29.6797512438,201,25.9115112821,397
ME,2020,7,9,14.08644663,197,36.9750793651,189,25.2935750935,386
ME,2020,7,10,11.5249426,174,18.1634946237,186,14.9548611456,360
ME,2020,7,11,9.424525092,179,54.3798802395,167,31.1226300331,346
ME,2020,7,12,14.04768349,177,37.9543333333,180,26.1014565203,357
ME,2020,7,13,8.563939213,198,30.7705583756,197,19.6391391498,395
ME,2020,7,14,15.7774356,195,19.9505479452,219,17.9849515507,414
ME,2020,7,15,26.77421099,171,33.5834090909,176,30.2278676637,347
ME,2020,7,16,18.60625001,176,19.7045977011,174,19.1522857193,350
ME,2020,7,17,15.33714311,175,19.5188571429,210,17.618078037,385
ME,2020,7,18,15.50887652,178,53.0773958333,192,35.0038919475,370
ME,2020,7,19,15.92120223,183,41.9426130653,199,29.4768586599,382
ME,2020,7,20,20.16131413,175,27.2994764398,191,23.8864206906,366
ME,2020,7,21,16.0877298,185,20.4939378238,193,18.3374603519,378
ME,2020,7,22,17.87371716,191,24.8401546392,194,21.3840778638,385
ME,2020,7,23,16.38885866,184,32.21,197,24.5693438148,381
ME,2020,7,24,18.44587321,189,28.6680526316,190,23.5704486456,379
ME,2020,7,25,10.24384153,164,29.4514,200,20.7974450849,364
ME,2020,7,26,14.61954823,177,33.163027027,185,24.0961879467,362
ME,2020,7,27,8.772791777,197,37.4155329949,197,23.094162386,394
ME,2020,7,28,23.54544017,193,24.6845728643,199,24.1237243694,392
ME,2020,7,29,9.839255819,215,36.9482692308,208,23.1694562673,423
ME,2020,7,30,15.16945813,203,33.5544144144,222,24.7728941186,425
ME,2020,7,31,26.45899982,200,42.6255670103,194,34.4191877259,394
MI,2020,1,1,21.14690782,2626,38.8578077572,2965,30.5392917073,5591
MI,2020,1,2,13.32343224,2663,29.522694922,2501,21.1689698015,5164
MI,2020,1,3,16.84619831,2683,28.022090355,2789,22.5423903629,5472
MI,2020,1,4,15.93077776,2713,29.7471116864,2704,22.8274672444,5417
MI,2020,1,5,19.5017464,2594,28.5381953522,2754,24.1551458791,5348
MI,2020,1,6,14.28929188,2697,28.981863162,2587,21.4826457609,5284
MI,2020,1,7,10.66743404,2767,26.7447835577,2749,18.6798767202,5516
MI,2020,1,8,13.33632402,2753,28.9172512204,2663,20.9973301379,5416
MI,2020,1,9,13.13767936,2788,32.9008499818,2753,22.9568471496,5541
MI,2020,1,10,15.42515008,2598,32.7827476038,2817,24.4549473514,5415
MI,2020,1,11,12.29301625,2523,21.2621150855,2572,16.8206947986,5095
MI,2020,1,12,16.39450841,2604,31.2265550798,2569,23.7603556736,5173
MI,2020,1,13,10.53044621,2801,29.1369225302,2814,19.8552234789,5615
MI,2020,1,14,10.80609906,2179,25.9208493248,2814,19.3246064193,4993
MI,2020,1,15,12.41562186,1978,21.0619933555,1806,16.5422991647,3784
MI,2020,1,16,13.30961537,2600,29.7051506515,2456,21.2739022868,5056
MI,2020,1,17,15.58461159,2587,35.7460488506,2784,26.0350754391,5371
MI,2020,1,18,14.01929766,2506,19.8496025437,2516,16.9402548658,5022
MI,2020,1,19,14.64050099,2475,29.2952149682,2512,22.0222217666,4987
MI,2020,1,20,12.38560422,2582,24.2184804298,2606,18.3294121234,5188
MI,2020,1,21,10.03991214,2617,28.2502264006,2606,19.1258931783,5223
MI,2020,1,22,11.57575433,2678,29.1822836985,2693,20.4036045607,5371
MI,2020,1,23,14.85128798,2694,28.0536203669,2671,21.4241546725,5365
MI,2020,1,24,17.11310996,2492,28.9381046729,2675,23.2350106484,5167
MI,2020,1,25,13.6790549,2677,30.9712909441,2595,22.1906923307,5272
MI,2020,1,26,14.93865805,2690,27.1012082092,3021,21.3723936534,5711
MI,2020,1,27,13.51739306,2593,26.8176418865,2502,20.048741944,5095
MI,2020,1,28,13.60828874,2653,29.4971023152,2678,21.5899512338,5331
MI,2020,1,29,12.15563996,2672,29.5074110522,2642,20.7825460996,5314
MI,2020,1,30,14.11079167,2741,32.9832932783,2663,23.4108419629,5404
MI,2020,1,31,17.50573716,2564,29.7592154116,2855,23.9614818377,5419
MI,2020,2,1,15.13573454,2682,40.7976337053,2599,27.7650236766,5281
MI,2020,2,2,12.55109554,1862,28.5334595469,3090,22.5239357624,4952
MI,2020,2,3,21.56446378,1613,16.8641613588,1413,19.3696431187,3026
MI,2020,2,4,12.69973392,2518,20.5985238721,2283,16.4558133744,4801
MI,2020,2,5,13.47801054,2674,26.4799373695,2874,20.2133273583,5548
MI,2020,2,6,23.35095993,1271,24.3361508402,2559,24.0092115068,3830
MI,2020,2,7,9.229083083,1385,11.7814963119,949,10.2668894901,2334
MI,2020,2,8,15.35596575,2573,24.6225632563,2727,20.1238924292,5300
MI,2020,2,9,17.01623682,2365,27.9343629949,2551,22.6818470462,4916
MI,2020,2,10,12.279633,2425,27.9491791667,2400,20.0738114041,4825
MI,2020,2,11,9.969438062,2456,27.2235669538,2554,18.7652554651,5010
MI,2020,2,12,12.42577596,2500,26.1174552597,2291,18.9729763932,4791
MI,2020,2,13,16.11927385,2837,31.7429895042,2763,23.8279035558,5600
MI,2020,2,14,17.58751681,2678,28.9175149595,2841,23.4198278705,5519
MI,2020,2,15,17.75764971,2421,23.7352689487,2454,20.7666912714,4875
MI,2020,2,16,19.77023853,2473,31.0125262274,2383,25.2872013766,4856
MI,2020,2,17,15.94990906,2531,32.0629181218,2577,24.0789662942,5108
MI,2020,2,18,11.04385072,2680,30.4046052632,2584,20.5476861568,5264
MI,2020,2,19,14.94695603,2707,28.5114005093,2749,21.7813874584,5456
MI,2020,2,20,18.42235095,2650,31.4700360577,2496,24.7509599723,5146
MI,2020,2,21,16.84076078,2550,30.5354061407,2573,23.7188249051,5123
MI,2020,2,22,16.32965716,2480,25.6378937321,3143,21.5325359696,5623
MI,2020,2,23,21.6844119,2389,26.6053899269,2462,24.1819274436,4851
MI,2020,2,24,13.03782926,2612,34.0230377734,2515,23.3319192563,5127
MI,2020,2,25,13.95327229,2784,25.6433464426,2797,19.8119243962,5581
MI,2020,2,26,18.41110425,2726,25.5912481315,2676,21.967947091,5402
MI,2020,2,27,20.72358711,2693,32.3405998481,2634,26.4677604819,5327
MI,2020,2,28,17.81366596,2586,36.5236962118,2719,27.4032177517,5305
MI,2020,2,29,15.16806344,2396,32.2732859885,2605,24.07810238,5001
MI,2020,3,1,16.40156693,2323,27.1201826678,2354,21.7963972586,4677
MI,2020,3,2,17.1113004,2453,29.3949795417,2444,23.2418521301,4897
MI,2020,3,3,11.88805815,2544,29.9091700242,2482,20.7874611885,5026
MI,2020,3,4,16.81868188,2678,34.8603099017,2646,25.7852761222,5324
MI,2020,3,5,23.04647668,2651,32.91213263,2654,27.9820941901,5305
MI,2020,3,6,19.75371388,2531,33.2577491474,2639,26.6467794643,5170
MI,2020,3,7,20.90679107,2384,28.6648135061,2547,24.9140275625,4931
MI,2020,3,8,24.54766699,2456,32.4714879739,2453,28.5071562696,4909
MI,2020,3,9,14.32978606,2804,32.5864511041,2536,22.9999925304,5340
MI,2020,3,10,12.75861103,3146,29.7237957166,3035,21.0888707815,6181
MI,2020,3,11,12.52273607,3304,32.6616181029,3226,22.4718989242,6530
MI,2020,3,12,13.20071701,3236,30.3137897898,3330,21.8797502657,6566
MI,2020,3,13,14.2144495,2906,25.9494180754,3076,20.2486794127,5982
MI,2020,3,14,12.23199565,2786,23.7619422092,2734,17.9426612103,5520
MI,2020,3,15,12.32129593,2909,22.49912996,2747,17.2644554209,5656
MI,2020,3,16,9.193615599,3236,20.6466233766,3157,14.8493555574,6393
MI,2020,3,17,6.709645438,3328,18.489372513,3267,12.5450310868,6595
MI,2020,3,18,7.664748202,3277,19.0830519274,3139,13.2511034691,6416
MI,2020,3,19,7.638066233,3351,20.5027122347,3204,13.9261403428,6555
MI,2020,3,20,6.31310355,3148,18.5750589658,3307,12.5950999187,6455
MI,2020,3,21,6.125225667,2991,17.8696169631,2924,11.9309061657,5915
MI,2020,3,22,8.434341114,3096,14.9047292666,2918,11.573781192,6014
MI,2020,3,23,6.302689671,3242,15.856657416,3243,11.080410164,6485
MI,2020,3,24,6.120973323,3185,15.2651507293,3085,10.6201419512,6270
MI,2020,3,25,6.352910285,3223,16.278055203,3152,11.2602133096,6375
MI,2020,3,26,5.498248654,3386,15.6680492365,3209,10.4466777775,6595
MI,2020,3,27,6.23200371,3209,15.6479733817,3306,11.010084406,6515
MI,2020,3,28,4.772020172,3074,15.2655343264,3088,10.0306978268,6162
MI,2020,3,29,4.552062989,3049,16.7857161937,2995,10.6142389235,6044
MI,2020,3,30,5.523380609,3103,18.9308238826,2998,12.1117292296,6101
MI,2020,3,31,6.037777097,3239,14.7283543046,3020,10.2310257257,6259
MI,2020,4,1,5.108731638,3201,15.4464854071,3255,10.3208426229,6456
MI,2020,4,2,4.642706068,3045,18.6820956123,3054,11.672759465,6099
MI,2020,4,3,5.801552863,2930,16.0676847123,2937,10.9407431206,5867
MI,2020,4,4,4.952341726,2874,15.3522855158,2879,10.1568329777,5753
MI,2020,4,5,3.929353935,2848,12.6355052517,2761,8.21490996735,5609
MI,2020,4,6,3.70530831,2984,11.9438726885,2812,7.70234817064,5796
MI,2020,4,7,3.369387726,3005,13.8988435604,2966,8.59972870819,5971
MI,2020,4,8,5.494816009,2772,16.4827609657,2941,11.1513092906,5713
MI,2020,4,9,4.487563341,2762,12.4033477577,2542,8.28128958293,5304
MI,2020,4,10,5.476363301,2791,17.8633427762,2824,11.7062528892,5615
MI,2020,4,11,3.022949929,2756,11.5951530993,2678,7.2475285249,5434
MI,2020,4,12,2.50640441,2720,12.5749962825,2690,7.51278373294,5410
MI,2020,4,13,4.358812452,2863,13.5418457694,2801,8.90006886477,5664
MI,2020,4,14,4.759525524,3077,10.8471266407,2819,7.67013399548,5896
MI,2020,4,15,3.95546091,3135,15.8232945249,3178,9.92979565228,6313
MI,2020,4,16,3.804040375,3022,16.9088396842,2913,10.2361010974,5935
MI,2020,4,17,4.069176409,2817,16.517777403,2965,10.45279833,5782
MI,2020,4,18,2.938675252,2559,15.7136356649,2602,9.37937414646,5161
MI,2020,4,19,5.115776805,2581,12.9314515496,2549,8.99923780384,5130
MI,2020,4,20,5.16652074,2650,12.1433399366,2524,8.56997873232,5174
MI,2020,4,21,3.45005933,2698,11.0520488941,2577,7.16386541656,5275
MI,2020,4,22,5.108920328,2862,14.4019280682,2697,9.61750854088,5559
MI,2020,4,23,4.247162727,3024,16.4516750757,2973,10.2975237763,5997
MI,2020,4,24,4.84151841,2766,13.2659831756,2853,9.11896955367,5619
MI,2020,4,25,4.521382269,2561,15.8095091547,2567,10.1720495302,5128
MI,2020,4,26,5.558873072,2458,14.5528280814,2507,10.1002316236,4965
MI,2020,4,27,4.875136735,2414,17.1464571911,2371,10.9556593685,4785
MI,2020,4,28,3.32591123,2502,16.329369483,2379,9.66379838096,4881
MI,2020,4,29,4.509064269,2661,14.0947660587,2522,9.17337835613,5183
MI,2020,4,30,5.116558139,2641,15.7550912477,2685,10.4797690659,5326
MI,2020,5,1,6.056648353,2366,20.3116413486,2699,13.6527443244,5065
MI,2020,5,2,5.469960407,2271,18.4966149068,2254,11.9588176982,4525
MI,2020,5,3,6.344243349,2293,15.5406588643,2307,10.956445652,4600
MI,2020,5,4,5.923537449,2482,15.8570229338,2311,10.7130815665,4793
MI,2020,5,5,7.11645316,2467,16.3625214548,2447,11.7206715396,4914
MI,2020,5,6,6.956088606,2439,21.6291190174,2361,14.1733854396,4800
MI,2020,5,7,4.420073134,2462,18.2053739496,2380,11.195995468,4842
MI,2020,5,8,5.474205949,2418,18.198043045,2509,11.9536269504,4927
MI,2020,5,9,6.31551925,2234,17.1716264237,2195,11.6957755711,4429
MI,2020,5,10,7.311157993,2228,19.8063415711,2266,13.611577661,4494
MI,2020,5,11,5.623661041,2319,15.7040561896,2278,10.6189057981,4597
MI,2020,5,12,4.830798147,2368,15.9929576271,2360,10.4024344357,4728
MI,2020,5,13,5.215882107,2188,22.8217375,2400,14.4255710658,4588
MI,2020,5,14,5.809986618,2242,14.6541904762,2100,10.0874689078,4342
MI,2020,5,15,6.144926174,2302,22.5845410433,2473,14.6590973932,4775
MI,2020,5,16,6.274498845,2185,22.3220789832,2203,14.3312032763,4388
MI,2020,5,17,8.950226636,2207,14.3351184622,2237,11.6608483766,4444
MI,2020,5,18,7.869096725,2347,17.4858567775,2346,12.6764521657,4693
MI,2020,5,19,7.986129255,2413,15.94480121,2314,11.8821239459,4727
MI,2020,5,20,6.914275679,2423,21.9643279352,2470,14.5115838893,4893
MI,2020,5,21,10.26086979,2380,25.6314213625,2378,17.9429151114,4758
MI,2020,5,22,8.264951987,2189,23.5848219522,2387,16.2563264641,4576
MI,2020,5,23,10.03375978,2040,19.5600708885,2116,14.8840182751,4156
MI,2020,5,24,9.049512527,2072,22.0363339552,2144,15.6538164032,4216
MI,2020,5,25,10.00240175,2140,17.4111600928,2155,13.7197182177,4295
MI,2020,5,26,7.411591463,2281,20.9599955536,2249,14.1379404254,4530
MI,2020,5,27,5.960493193,2352,19.2756748599,2319,12.5710490237,4671
MI,2020,5,28,6.822530948,2505,17.4620879121,2457,12.0908484532,4962
MI,2020,5,29,11.63971704,2438,19.8310670262,2596,15.8639412284,5034
MI,2020,5,30,7.636392955,2387,17.4462106588,2383,12.5371886758,4770
MI,2020,5,31,10.13729637,2419,18.9316860232,2497,14.6042595441,4916
MI,2020,6,1,9.619495395,2477,22.2490330189,2544,16.0185282002,5021
MI,2020,6,2,7.773606351,2515,19.1638063505,2551,13.50917686,5066
MI,2020,6,3,7.18164636,2381,19.9301288764,2483,13.6895579735,4864
MI,2020,6,4,8.773901358,2312,19.0618501465,2389,14.0021314486,4701
MI,2020,6,5,7.090757248,2060,25.3508029838,2279,16.6815948216,4339
MI,2020,6,6,7.808349387,1975,23.0734394597,2073,15.6256744168,4048
MI,2020,6,7,9.266323346,1942,18.7867047146,2015,14.1143315486,3957
MI,2020,6,8,9.091793614,2035,18.8698943662,1988,13.9237260762,4023
MI,2020,6,9,10.26485498,2173,20.9519293219,2094,15.5094609495,4267
MI,2020,6,10,9.251753815,2218,18.6690288248,2255,13.9993404788,4473
MI,2020,6,11,9.741471866,2079,21.3454056477,2231,15.7480556866,4310
MI,2020,6,12,8.474279029,1914,24.9401714846,2041,16.9715954644,3955
MI,2020,6,13,9.150502296,1931,22.4312107161,1941,15.8080061812,3872
MI,2020,6,14,11.54073304,1978,21.7313316708,2005,16.6705724211,3983
MI,2020,6,15,7.618791439,2168,25.3072334559,2176,16.4793001473,4344
MI,2020,6,16,10.40688654,2213,19.5306766917,2128,14.8794563264,4341
MI,2020,6,17,9.451841489,2259,22.7885701316,2203,16.0365149986,4462
MI,2020,6,18,10.76877791,2234,25.4663875493,2281,18.194081916,4515
MI,2020,6,19,10.9172774,2123,31.4227101968,2236,21.4357788301,4359
MI,2020,6,20,10.05164593,2096,29.9612665037,2045,19.8838541099,4141
MI,2020,6,21,11.941607,2122,25.0109901455,2131,18.4901269819,4253
MI,2020,6,22,10.72849194,2228,26.3531180297,2152,18.4052488681,4380
MI,2020,6,23,9.14193239,2189,23.1202595078,2235,16.2037680836,4424
MI,2020,6,24,9.237557533,2174,25.7365382809,2129,17.4007762205,4303
MI,2020,6,25,12.35801716,2214,23.3887958608,2126,17.7615737309,4340
MI,2020,6,26,13.02937681,2102,28.506472937,2254,21.0379568537,4356
MI,2020,6,27,12.91552654,1994,23.2805227493,2066,18.189931015,4060
MI,2020,6,28,13.08794511,2078,30.5695558809,2049,21.7673297646,4127
MI,2020,6,29,11.20831766,2235,20.9662427488,2241,16.0938203687,4476
MI,2020,6,30,10.36140703,2189,26.9473606272,2296,18.8522318815,4485
MI,2020,7,1,11.18908154,2232,28.8450358196,2373,20.2873615629,4605
MI,2020,7,2,15.47082546,2108,25.6221486854,2206,20.6617895386,4314
MI,2020,7,3,16.28549037,2080,29.6389882353,2125,23.033690837,4205
MI,2020,7,4,14.54327162,1999,25.8079485912,2023,20.209219286,4022
MI,2020,7,5,16.85497007,2004,23.4253865337,2005,20.1409977601,4009
MI,2020,7,6,12.12345607,2173,27.5883494253,2175,19.8594595308,4348
MI,2020,7,7,9.571288309,2282,22.151785552,2201,15.7478830964,4483
MI,2020,7,8,10.26516626,2346,26.0194716495,2328,18.1119833218,4674
MI,2020,7,9,10.63784534,2367,23.3358838278,2393,17.0215441008,4760
MI,2020,7,10,12.0335498,2217,27.32593361,2410,19.9986773085,4627
MI,2020,7,11,12.99343996,2032,23.7606426859,2085,18.4463468542,4117
MI,2020,7,12,11.6815894,2114,28.7077788416,2089,20.1440471072,4203
MI,2020,7,13,12.9618123,2334,21.2853063885,2301,17.0939287828,4635
MI,2020,7,14,8.959600326,2302,26.7845945946,2294,17.8565839753,4596
MI,2020,7,15,10.43729684,2338,23.7729982744,2318,17.0765055868,4656
MI,2020,7,16,12.93295761,2289,28.7882625483,2331,20.932679647,4620
MI,2020,7,17,14.83230796,2058,31.763336256,2281,23.7329015399,4339
MI,2020,7,18,12.2081366,1991,27.8689219512,2050,20.1528557215,4041
MI,2020,7,19,12.03284833,2096,24.3538093001,2129,18.2414461774,4225
MI,2020,7,20,8.44775995,2241,26.1733150183,2184,17.1963728922,4425
MI,2020,7,21,9.229160307,2263,24.8450313059,2236,16.9902377806,4499
MI,2020,7,22,10.3285163,2332,20.3619471366,2270,15.2776445049,4602
MI,2020,7,23,13.01209341,2355,22.3526340426,2350,17.6774006335,4705
MI,2020,7,24,13.51761573,2139,27.3825207877,2285,20.6788517284,4424
MI,2020,7,25,9.995450505,2031,25.3056083374,2063,17.7103639413,4094
MI,2020,7,26,14.24724554,2073,26.9936754643,2046,20.5786841477,4119
MI,2020,7,27,12.49232237,2196,23.3336082949,2170,17.8806848201,4366
MI,2020,7,28,13.30196452,2255,32.9271811785,2274,23.155738572,4529
MI,2020,7,29,10.48391436,2266,27.3375777486,2283,18.9422378412,4549
MI,2020,7,30,11.69035098,2308,25.3030217391,2300,18.4848698051,4608
MI,2020,7,31,14.79441476,2093,29.3155700043,2307,22.4081204756,4400
MN,2020,1,1,21.65546741,1412,26.2643154762,1680,24.1596280669,3092
MN,2020,1,2,25.43484276,1303,23.0032576351,1277,24.2313023707,2580
MN,2020,1,3,25.1331272,1375,25.1981113619,1329,25.1650665311,2704
MN,2020,1,4,19.45442315,1560,21.5009938314,1459,20.4434746982,3019
MN,2020,1,5,21.714454,1401,19.1086348315,1780,20.2563093537,3181
MN,2020,1,6,25.51481686,1312,28.0788984375,1280,26.7810299847,2592
MN,2020,1,7,17.92172317,1329,21.9791200597,1341,19.9595393606,2670
MN,2020,1,8,23.95442524,1322,19.1399672668,1222,21.6418200343,2544
MN,2020,1,9,24.1374301,1432,27.5955748373,1383,25.836404939,2815
MN,2020,1,10,19.99251587,1407,24.4597218155,1366,22.1930940603,2773
MN,2020,1,11,21.73037675,1407,18.8530418719,1624,20.1887100255,3031
MN,2020,1,12,26.32759792,1278,23.4370260747,1419,24.8067519992,2697
MN,2020,1,13,20.44335723,1388,23.9021567164,1340,22.1423276522,2728
MN,2020,1,14,10.41527035,1091,26.7607510431,1438,19.7093791822,2529
MN,2020,1,15,26.66374018,1024,15.7803472222,864,21.6832044197,1888
MN,2020,1,16,23.30506848,1387,26.5311136364,1320,24.8781677066,2707
MN,2020,1,17,18.11327261,1427,21.7516957105,1492,19.972994181,2919
MN,2020,1,18,19.23342031,1380,24.637057971,1380,21.9352391405,2760
MN,2020,1,19,27.38757068,1309,18.9183201581,1518,22.8398797383,2827
MN,2020,1,20,22.55346733,1318,23.0129883268,1285,22.7803149984,2603
MN,2020,1,21,13.82247238,1355,28.2601768607,1357,21.0466482577,2712
MN,2020,1,22,17.95716036,1384,25.9555391433,1354,21.912531022,2738
MN,2020,1,23,32.3603796,1449,27.2308595989,1396,29.8433989597,2845
MN,2020,1,24,22.55986315,1461,24.3677075099,1518,23.4810809205,2979
MN,2020,1,25,20.42500687,1444,20.1194656489,1441,20.2723951197,2885
MN,2020,1,26,35.26516781,1401,21.0234622583,1603,27.6654827236,3004
MN,2020,1,27,21.2853011,1328,44.6595511811,1270,32.7115126485,2598
MN,2020,1,28,18.75197901,1334,27.2612032885,1338,23.0129603291,2672
MN,2020,1,29,17.78610416,1345,25.348132033,1333,21.5501755397,2678
MN,2020,1,30,26.83762388,1372,30.7825948407,1318,28.7705129975,2690
MN,2020,1,31,24.30092903,1367,26.332342216,1426,25.338091652,2793
MN,2020,2,1,20.77571811,1504,32.3802090592,1435,26.4417421019,2939
MN,2020,2,2,18.77763967,894,19.3280548926,1676,19.1365874961,2570
MN,2020,2,3,37.12526803,765,18.6545107034,654,28.6123185644,1419
MN,2020,2,4,16.23931519,1285,21.2327175698,1218,18.6691849857,2503
MN,2020,2,5,18.00364244,1337,20.8077233042,1489,19.4810933978,2826
MN,2020,2,6,37.68590483,674,31.9700546022,1282,33.9396267154,1956
MN,2020,2,7,13.23727617,782,8.85911564626,588,11.3581824562,1370
MN,2020,2,8,19.37651768,1364,22.4158672377,1401,20.9165280707,2765
MN,2020,2,9,32.0985702,1238,20.5102690909,1375,26.0006314227,2613
MN,2020,2,10,21.39438232,1246,14.7021614802,1189,18.1265997416,2435
MN,2020,2,11,14.44962495,1173,26.144727133,1301,20.5997170842,2474
MN,2020,2,12,19.67704075,1230,23.595904936,1094,21.5218072816,2324
MN,2020,2,13,21.47345796,1498,28.032911032,1405,24.6481157506,2903
MN,2020,2,14,16.83875286,1363,26.4389421813,1522,21.9033934656,2885
MN,2020,2,15,17.72529744,1227,19.852496136,1294,18.8171638076,2521
MN,2020,2,16,26.78645964,1175,22.9891042345,1228,24.8459051506,2403
MN,2020,2,17,25.33873415,1264,18.0585915493,1278,21.67861525,2542
MN,2020,2,18,18.83084793,1368,24.3266614543,1279,21.4863619072,2647
MN,2020,2,19,21.00371538,1405,25.0945614035,1425,23.0635936781,2830
MN,2020,2,20,19.22514095,1420,32.377033046,1392,25.7356081611,2812
MN,2020,2,21,28.77194367,1348,26.5771103203,1405,27.6518053277,2753
MN,2020,2,22,20.0325357,1262,24.3072998873,1774,22.5303722179,3036
MN,2020,2,23,35.1891014,1191,20.8822525331,1283,27.7696644169,2474
MN,2020,2,24,21.45955668,1263,30.3564117168,1229,25.8472913671,2492
MN,2020,2,25,19.13499997,1348,24.6908090379,1372,21.9374154263,2720
MN,2020,2,26,22.48438146,1358,25.7127449568,1388,24.1161981146,2746
MN,2020,2,27,21.11615701,1439,24.1063446287,1387,22.5837402468,2826
MN,2020,2,28,28.65936853,1394,23.4712491373,1449,26.0151247734,2843
MN,2020,2,29,29.39938966,1294,29.646831037,1379,29.5270446016,2673
MN,2020,3,1,32.09760961,1255,33.2735885167,1254,32.6853647113,2509
MN,2020,3,2,23.34625183,1414,26.040309119,1294,24.6335893972,2708
MN,2020,3,3,18.64691622,1469,20.7667553191,1504,19.7193137999,2973
MN,2020,3,4,23.23666195,1420,17.861656051,1413,20.5557994949,2833
MN,2020,3,5,24.01601131,1409,21.1252924595,1419,22.5655409957,2828
MN,2020,3,6,29.11539779,1408,26.4750351617,1422,27.7886855436,2830
MN,2020,3,7,21.45530301,1320,24.4678079179,1364,22.9862481271,2684
MN,2020,3,8,28.07075087,1172,19.0057753165,1264,23.3670853939,2436
MN,2020,3,9,18.04646681,1285,23.1547147651,1192,20.5046951356,2477
MN,2020,3,10,18.61497615,1467,21.0918998527,1358,19.8056531016,2825
MN,2020,3,11,19.29865344,1656,22.3282072473,1573,20.7744936812,3229
MN,2020,3,12,21.84261124,1708,26.2976276102,1724,24.0805040786,3432
MN,2020,3,13,20.49240774,1520,22.7778100423,1653,21.6830065442,3173
MN,2020,3,14,16.33686208,1552,21.6953536068,1414,18.8914497465,2966
MN,2020,3,15,11.8406557,1647,18.255752322,1615,15.0167381784,3262
MN,2020,3,16,15.64877142,1758,16.4951692484,1743,16.0701571426,3501
MN,2020,3,17,10.53177437,1781,14.9754973822,1719,12.7142771866,3500
MN,2020,3,18,6.869786526,1780,14.1524349882,1692,10.4188191291,3472
MN,2020,3,19,7.952558998,1864,15.7517574692,1707,11.6807112776,3571
MN,2020,3,20,10.41692913,1765,13.3585926333,1819,11.9099218511,3584
MN,2020,3,21,8.694619548,1643,16.8341498216,1682,12.8121202759,3325
MN,2020,3,22,6.811096528,1596,13.0455597484,1590,9.92245764554,3186
MN,2020,3,23,6.250271438,1695,10.3449618806,1574,8.22183545042,3269
MN,2020,3,24,7.1423455,1748,11.5116392444,1641,9.25801709472,3389
MN,2020,3,25,6.049086774,1763,11.0988998836,1718,8.54135305446,3481
MN,2020,3,26,8.125830064,1777,12.6957923497,1647,10.3240566658,3424
MN,2020,3,27,5.815771772,1639,14.394040404,1683,10.1617158141,3322
MN,2020,3,28,4.763182145,1587,10.9742801047,1528,7.80991013294,3115
MN,2020,3,29,6.450648025,1543,12.1739427456,1537,9.30672074759,3080
MN,2020,3,30,7.482968863,1573,10.0128098637,1541,8.73489082258,3114
MN,2020,3,31,8.249656865,1603,12.6575699659,1465,10.3544784728,3068
MN,2020,4,1,5.345636934,1680,12.0747710396,1616,8.64487258772,3296
MN,2020,4,2,6.453453388,1610,11.5780871828,1537,8.95633300117,3147
MN,2020,4,3,6.575756588,1520,17.6463492063,1575,12.2094184212,3095
MN,2020,4,4,4.847240416,1464,10.2651403743,1496,7.58547634089,2960
MN,2020,4,5,5.380742295,1428,8.7018938307,1394,7.02131112589,2822
MN,2020,4,6,5.269390223,1476,12.9756509091,1375,8.9860189299,2851
MN,2020,4,7,6.342263546,1586,10.0335124244,1489,8.12966828747,3075
MN,2020,4,8,4.189362546,1459,13.7729415627,1523,9.08399394856,2982
MN,2020,4,9,10.52653985,1419,13.4422627183,1317,11.9300511868,2736
MN,2020,4,10,7.183922743,1397,10.5923164647,1403,8.89177145428,2800
MN,2020,4,11,3.565727646,1388,7.83427944404,1367,5.6837350173,2755
MN,2020,4,12,6.538135413,1373,11.0820527859,1364,8.80262328171,2737
MN,2020,4,13,6.29087199,1445,9.45188104089,1345,7.81472760772,2790
MN,2020,4,14,3.879851837,1485,10.7349546142,1322,7.10836835695,2807
MN,2020,4,15,6.650473939,1498,9.01902188782,1462,7.82034458129,2960
MN,2020,4,16,6.071783138,1531,7.35074895978,1442,6.69212242996,2973
MN,2020,4,17,4.747212349,1460,9.03760152284,1576,6.97437089247,3036
MN,2020,4,18,3.524156327,1369,7.94914221219,1329,5.70384729861,2698
MN,2020,4,19,5.024916395,1316,9.76823170732,1312,7.39296422215,2628
MN,2020,4,20,4.672067265,1427,10.1141666667,1344,7.31161313142,2771
MN,2020,4,21,6.035665293,1428,15.8497525473,1374,10.8481406276,2802
MN,2020,4,22,8.033958307,1488,12.4607326007,1365,10.1519207714,2853
MN,2020,4,23,8.189728633,1548,13.9055271565,1565,11.0632347973,3113
MN,2020,4,24,7.063048042,1414,10.6107429719,1494,8.88569461189,2908
MN,2020,4,25,6.354653043,1225,9.69058167331,1255,8.04279434584,2480
MN,2020,4,26,4.488995815,1185,15.3303037975,1185,9.90964980623,2370
MN,2020,4,27,7.140715402,1286,8.91698675497,1208,8.00107458179,2494
MN,2020,4,28,4.486975081,1286,19.847393745,1247,12.0489340522,2533
MN,2020,4,29,3.646805636,1343,13.7770031546,1268,8.56641132484,2611
MN,2020,4,30,10.85682475,1455,16.1744716692,1306,13.3721622641,2761
MN,2020,5,1,9.813493944,1328,19.5003194263,1534,15.0055240942,2862
MN,2020,5,2,5.106855922,1180,15.8715821152,1163,10.4501664481,2343
MN,2020,5,3,5.048542866,1249,9.33350515464,1164,7.11555326964,2413
MN,2020,5,4,7.482688748,1298,9.66478998384,1238,8.5479258655,2536
MN,2020,5,5,6.074744774,1332,16.7060183767,1306,11.337990917,2638
MN,2020,5,6,6.738999978,1330,9.89116043614,1284,8.28734505384,2614
MN,2020,5,7,5.548788301,1337,14.2788623707,1257,9.77920584365,2594
MN,2020,5,8,5.439786857,1267,13.8972209026,1263,9.66181816119,2530
MN,2020,5,9,7.360929989,1215,14.6371808055,1167,10.9257430464,2382
MN,2020,5,10,7.649257063,1171,14.2480340426,1175,10.9542711086,2346
MN,2020,5,11,7.875464667,1259,8.30278015398,1169,8.0812026424,2428
MN,2020,5,12,5.038359284,1286,13.2530884676,1266,9.11353449813,2552
MN,2020,5,13,3.596552894,1201,8.90714068441,1315,6.37215819781,2516
MN,2020,5,14,4.997598679,1216,9.87807726076,1139,7.35805095272,2355
MN,2020,5,15,8.109991778,1207,13.904768,1250,11.058087129,2457
MN,2020,5,16,6.479934289,1217,13.5797270471,1209,10.018124497,2426
MN,2020,5,17,5.201071167,1195,14.9412876254,1196,10.0732162462,2391
MN,2020,5,18,5.850282912,1202,9.4693639576,1132,7.60555272503,2334
MN,2020,5,19,4.78504451,1235,12.5795733788,1172,8.58030326957,2407
MN,2020,5,20,7.336858716,1267,13.2422179586,1303,10.33089883,2570
MN,2020,5,21,7.256901597,1220,10.5251300236,1269,8.92318599773,2489
MN,2020,5,22,8.853924853,1144,14.5466176471,1224,11.7964316013,2368
MN,2020,5,23,8.494123882,1130,14.8828243601,1133,11.6927087877,2263
MN,2020,5,24,9.845535733,1129,16.4273721973,1115,13.1159223897,2244
MN,2020,5,25,15.47214465,1189,14.0681330869,1082,14.8032144381,2271
MN,2020,5,26,21.05141047,1418,17.2002795699,1395,19.1415890674,2813
MN,2020,5,27,16.31946969,1584,34.4478888107,1421,24.8920099797,3005
MN,2020,5,28,23.20822997,2113,51.046828322,2062,36.9574969884,4175
MN,2020,5,29,25.17142731,2179,63.4696116108,2446,45.4259913748,4625
MN,2020,5,30,13.92788495,2000,32.9610340314,2292,24.0919058481,4292
MN,2020,5,31,18.24332391,1778,25.1983039216,2040,21.9594473316,3818
MN,2020,6,1,20.39499999,1682,35.2960334873,1732,27.9546338556,3414
MN,2020,6,2,12.13251114,1549,26.4091529555,1641,19.4767021178,3190
MN,2020,6,3,15.54051721,1431,22.7163552632,1520,19.2366452482,2951
MN,2020,6,4,10.74474874,1373,32.5376174033,1448,21.930879128,2821
MN,2020,6,5,15.24178164,1246,17.859566787,1385,16.6198251324,2631
MN,2020,6,6,14.87087181,1193,23.7267871816,1217,19.34292534,2410
MN,2020,6,7,13.63569076,1158,28.8440067058,1193,21.3530539771,2351
MN,2020,6,8,12.50153131,1182,19.1487085515,1146,15.7737242304,2328
MN,2020,6,9,5.816375421,1236,19.7089879518,1245,12.7878798953,2481
MN,2020,6,10,9.264138173,1230,16.7953517787,1265,13.0825691194,2495
MN,2020,6,11,9.078212841,1231,12.8628536585,1230,10.9697643264,2461
MN,2020,6,12,10.8616088,1094,21.8388916667,1200,16.6038666204,2294
MN,2020,6,13,6.984914451,1052,15.100653951,1101,11.1351370193,2153
MN,2020,6,14,9.755353453,1061,14.3507247706,1090,12.0840167427,2151
MN,2020,6,15,8.543178704,1164,15.5660035211,1136,12.0118434832,2300
MN,2020,6,16,7.31088145,1248,16.6993044953,1179,11.8716357848,2427
MN,2020,6,17,8.457749974,1320,11.1504552846,1230,9.75658430027,2550
MN,2020,6,18,12.01621208,1320,15.625158546,1293,13.8020397802,2613
MN,2020,6,19,10.34593213,1180,18.7165625,1248,14.6484637205,2428
MN,2020,6,20,12.2365692,1163,19.1631765677,1212,15.7713263072,2375
MN,2020,6,21,13.90099905,1151,22.6191659501,1163,18.2826879458,2314
MN,2020,6,22,7.570882593,1201,14.4926988382,1119,10.9094655147,2320
MN,2020,6,23,9.451567735,1263,18.8162911184,1216,14.0451553244,2479
MN,2020,6,24,9.535208867,1221,17.9065430017,1186,13.6600124747,2407
MN,2020,6,25,9.382709258,1207,16.024464135,1185,12.6730435094,2392
MN,2020,6,26,11.59102379,1133,16.7725187032,1203,14.2594049461,2336
MN,2020,6,27,8.518069725,1119,19.7100902527,1108,14.0864391658,2227
MN,2020,6,28,14.75761639,1204,15.1988388215,1154,14.973549675,2358
MN,2020,6,29,13.35645347,1266,19.4373408893,1147,16.2469540377,2413
MN,2020,6,30,7.733735625,1218,19.300267423,1234,13.554738985,2452
MN,2020,7,1,10.53255045,1188,19.2736805012,1277,15.0609168092,2465
MN,2020,7,2,13.99295163,1135,25.6108519438,1209,19.9852901451,2344
MN,2020,7,3,15.18140442,1118,24.8610365854,1148,20.0852957377,2266
MN,2020,7,4,13.70640396,1040,21.678677686,1089,17.7842837569,2129
MN,2020,7,5,17.80578863,1040,20.9788824101,1029,19.3839005197,2069
MN,2020,7,6,13.86982378,1192,19.3936347673,1139,16.5689317657,2331
MN,2020,7,7,8.683444246,1202,11.8957631579,1140,10.2470836822,2342
MN,2020,7,8,11.23154036,1240,15.8167453214,1229,13.5139287349,2469
MN,2020,7,9,13.0937672,1237,20.0004883907,1249,16.5637972753,2486
MN,2020,7,10,13.33255921,1141,20.906875,1216,17.240224887,2357
MN,2020,7,11,10.61696557,1104,16.6087222222,1080,13.5799221563,2184
MN,2020,7,12,14.50146787,1165,20.7790480132,1208,17.6971344579,2373
MN,2020,7,13,10.87308374,1229,17.6423198012,1207,14.2271346127,2436
MN,2020,7,14,6.785726594,1273,19.0359688013,1218,12.7756081711,2491
MN,2020,7,15,9.946706435,1257,16.0252019002,1263,12.9931904717,2520
MN,2020,7,16,10.41113532,1242,19.4749518459,1246,14.9503296091,2488
MN,2020,7,17,9.001118766,1171,17.2341096979,1258,13.2650556093,2429
MN,2020,7,18,9.18130393,1089,21.4813584575,1141,15.4747399012,2230
MN,2020,7,19,11.93373323,1117,22.7073518519,1080,17.2298224934,2197
MN,2020,7,20,11.5061138,1248,19.4726109215,1172,15.3642686043,2420
MN,2020,7,21,7.780524651,1296,13.1612550282,1243,10.4147301881,2539
MN,2020,7,22,8.467598481,1320,17.302151608,1306,12.8613252075,2626
MN,2020,7,23,12.34285395,1314,20.9262452399,1313,16.632915908,2627
MN,2020,7,24,13.42871056,1264,20.3301520913,1315,16.9476696967,2579
MN,2020,7,25,12.49961694,1175,19.1788825449,1226,15.9101873821,2401
MN,2020,7,26,12.91365965,1134,26.5920944206,1165,19.8450978874,2299
MN,2020,7,27,10.70027216,1249,17.0148671096,1204,13.7996493795,2453
MN,2020,7,28,9.376485799,1272,14.5032012432,1287,11.9548690646,2559
MN,2020,7,29,15.01121747,1306,16.178442492,1252,15.5825097794,2558
MN,2020,7,30,10.75161198,1309,18.0888863976,1338,14.4604420407,2647
MN,2020,7,31,11.96207857,1121,23.3372374798,1238,17.9317465354,2359
MO,2020,1,1,25.46519466,1619,34.4345787546,1638,29.9760485583,3257
MO,2020,1,2,23.79170165,1622,29.826596324,1469,26.6597897368,3091
MO,2020,1,3,24.3754056,1689,28.1692189422,1626,26.2362624611,3315
MO,2020,1,4,19.52432593,1669,27.0227486757,1699,23.3069328911,3368
MO,2020,1,5,21.49596944,1568,25.5622173089,1583,23.5387718445,3151
MO,2020,1,6,17.61080544,1676,26.3408650066,1526,21.771352254,3202
MO,2020,1,7,15.18882349,1632,21.3436623215,1611,18.2463151205,3243
MO,2020,1,8,20.12395671,1663,28.9116840052,1538,24.3462386781,3201
MO,2020,1,9,22.13855032,1828,28.9755331412,1735,25.467813636,3563
MO,2020,1,10,22.07795231,1763,31.0849542334,1748,26.5622130227,3511
MO,2020,1,11,20.14280988,1961,22.1826376147,1744,21.1029879014,3705
MO,2020,1,12,31.23400837,1931,32.8360837887,2196,32.0864817452,4127
MO,2020,1,13,17.9363718,1764,36.3314920273,1756,27.113028368,3520
MO,2020,1,14,10.61202616,1377,25.7613094539,1703,18.9883993579,3080
MO,2020,1,15,17.7452999,1334,17.8524814815,1080,17.7932518917,2414
MO,2020,1,16,16.37044266,1762,29.2888715711,1604,22.5264616658,3366
MO,2020,1,17,21.25366336,1747,26.2471728595,1857,23.8266231659,3604
MO,2020,1,18,23.35160513,2056,31.2601412776,1628,26.8464739813,3684
MO,2020,1,19,26.41931747,2007,30.6148544485,2439,28.7209177153,4446
MO,2020,1,20,20.82518737,1735,37.9479051621,1666,29.2128521279,3401
MO,2020,1,21,15.41485479,1790,31.1666274279,1699,23.0853224632,3489
MO,2020,1,22,17.75096026,1812,25.8405440098,1636,21.5892894406,3448
MO,2020,1,23,16.36311162,1819,26.2046628571,1750,21.1887531624,3569
MO,2020,1,24,20.6366819,1760,24.5769186382,1733,22.5915717561,3493
MO,2020,1,25,18.65991685,1804,24.542412993,1724,21.5344699539,3528
MO,2020,1,26,23.70710613,1714,32.7804338735,1913,28.4926798751,3627
MO,2020,1,27,16.51349089,1650,31.4808106355,1542,23.7439442257,3192
MO,2020,1,28,17.61066711,1679,24.853019802,1616,21.1626070039,3295
MO,2020,1,29,18.67395929,1768,27.58003621,1657,22.9826802992,3425
MO,2020,1,30,22.56158054,1860,30.0176025791,1706,26.1285950096,3566
MO,2020,1,31,26.17614332,1758,28.6899512723,1847,27.4640776579,3605
MO,2020,2,1,22.44888725,2013,33.7449765808,1708,27.6339774346,3721
MO,2020,2,2,15.36305653,1626,30.5726528302,2650,24.7890224317,4276
MO,2020,2,3,37.69438567,1172,30.1387382779,1173,33.9149509617,2345
MO,2020,2,4,16.22027087,1735,27.4542186405,1427,21.2901138392,3162
MO,2020,2,5,18.08531631,1881,28.3959568609,2179,23.6190320146,4060
MO,2020,2,6,25.57157294,852,27.7506918642,1561,26.9812723352,2413
MO,2020,2,7,12.12132549,928,14.1535373134,670,12.9733792583,1598
MO,2020,2,8,23.8026717,1718,29.498338244,1697,26.6329926737,3415
MO,2020,2,9,23.98247744,1550,27.6188963415,1640,25.8519843361,3190
MO,2020,2,10,11.69647257,1511,25.8052805049,1426,18.5467143525,2937
MO,2020,2,11,12.38358844,1516,23.8490647021,1561,18.2001657702,3077
MO,2020,2,12,17.84761176,1545,21.7391017964,1336,19.6522041545,2881
MO,2020,2,13,20.746087,1748,23.8616756757,1665,22.2659976783,3413
MO,2020,2,14,27.72891743,1718,33.9980892449,1748,30.8906347792,3466
MO,2020,2,15,16.24827651,1584,21.3553497164,1587,18.8042289473,3171
MO,2020,2,16,23.70196015,1556,22.5412316911,1502,23.1318443405,3058
MO,2020,2,17,19.16943893,1622,28.5057042254,1562,23.7496042539,3184
MO,2020,2,18,17.3178601,1729,28.1561860175,1602,22.5304083197,3331
MO,2020,2,19,20.16288459,1716,29.580492183,1727,24.8867324881,3443
MO,2020,2,20,22.3497265,1718,26.5846101485,1616,24.4023875606,3334
MO,2020,2,21,23.79809293,1636,32.4864024024,1665,28.1804120065,3301
MO,2020,2,22,16.45370689,1624,27.3904741379,2088,22.605638467,3712
MO,2020,2,23,22.13401937,1555,29.5116111448,1651,25.9332720276,3206
MO,2020,2,24,20.70907005,1656,25.9413945803,1513,23.2071789217,3169
MO,2020,2,25,15.53141463,1746,25.4322096486,1679,20.3849722464,3425
MO,2020,2,26,22.07781229,1769,20.5187111111,1575,21.3434868245,3344
MO,2020,2,27,21.88845521,1709,35.1764674238,1673,28.4617386026,3382
MO,2020,2,28,21.81734723,1685,28.9762393162,1638,25.3461661398,3323
MO,2020,2,29,22.80002505,1596,22.8744928401,1676,22.8381693092,3272
MO,2020,3,1,23.84252645,1417,31.1720674803,1393,27.475996434,2810
MO,2020,3,2,17.7604978,1607,26.861774744,1465,22.1007877489,3072
MO,2020,3,3,17.14057053,1700,26.9604842767,1590,21.8863647116,3290
MO,2020,3,4,20.71433946,1756,30.9513799622,1587,25.5741011342,3343
MO,2020,3,5,19.80944384,1744,31.2530993042,1581,25.2507729495,3325
MO,2020,3,6,22.22174416,1720,28.8072439586,1738,25.5316338795,3458
MO,2020,3,7,25.08898374,1594,29.4737908497,1683,27.3409307542,3277
MO,2020,3,8,24.53400529,1513,26.8305249344,1524,25.686424104,3037
MO,2020,3,9,17.92210779,1651,31.9465928339,1535,24.6790395359,3186
MO,2020,3,10,17.37156613,1839,26.2924713303,1744,21.7137538691,3583
MO,2020,3,11,17.24620706,2067,28.9295260417,1920,22.8724855764,3987
MO,2020,3,12,20.78508367,2032,29.8047012733,2042,25.3059622036,4074
MO,2020,3,13,21.00174435,1823,25.6090429581,1839,23.3154587521,3662
MO,2020,3,14,16.77195629,1738,22.1730994825,1739,19.4733045821,3477
MO,2020,3,15,17.39772862,1805,22.4262853629,1626,19.7808336226,3431
MO,2020,3,16,15.90311955,1965,19.5979801325,1812,17.6757135069,3777
MO,2020,3,17,11.62599609,2048,17.3201553599,1931,14.3893591335,3979
MO,2020,3,18,11.04854241,2072,17.9856494192,1894,14.3614220559,3966
MO,2020,3,19,9.846751237,2010,17.5171665802,1927,13.6011048987,3937
MO,2020,3,20,10.61542744,1942,19.5831761164,1993,15.1574155244,3935
MO,2020,3,21,9.360953652,1919,19.8357702215,1941,14.6282124503,3860
MO,2020,3,22,7.468815133,1823,15.9884920635,1764,11.6585865591,3587
MO,2020,3,23,7.16939394,1980,14.8236830949,1887,10.9044970264,3867
MO,2020,3,24,7.396191478,2048,9.88968041237,1940,8.6091725544,3988
MO,2020,3,25,8.558178646,2004,15.9309887295,1952,12.1961274031,3956
MO,2020,3,26,7.766168725,2015,14.6628638743,1910,11.1222675111,3925
MO,2020,3,27,7.676655885,1854,15.0279477994,1954,11.4488261583,3808
MO,2020,3,28,7.745409438,1734,13.0608865861,1737,10.4054451067,3471
MO,2020,3,29,5.773298577,1725,16.1617306556,1693,10.9188853263,3418
MO,2020,3,30,7.820180851,1880,12.5763396443,1743,10.1083356334,3623
MO,2020,3,31,7.911322236,1989,12.179679696,1842,9.96361000454,3831
MO,2020,4,1,6.408638625,1976,17.166479564,1835,11.5885489171,3811
MO,2020,4,2,7.24169911,1954,14.9906226716,1879,11.0403496115,3833
MO,2020,4,3,7.94375487,1787,13.3314501348,1855,10.6878994928,3642
MO,2020,4,4,7.468761525,1736,16.1493567961,1648,11.6961909005,3384
MO,2020,4,5,6.315973015,1706,10.4680565584,1662,8.36489310083,3368
MO,2020,4,6,5.240657343,1795,13.4745887192,1702,9.24813552493,3497
MO,2020,4,7,7.008331578,1918,12.9630791121,1757,9.85526801812,3675
MO,2020,4,8,6.644538728,1767,15.0488724685,1827,10.9168586345,3594
MO,2020,4,9,6.901509127,1703,11.7294990488,1577,9.22277135466,3280
MO,2020,4,10,7.780685248,1620,11.2800996483,1706,9.57563442627,3326
MO,2020,4,11,2.880440052,1568,10.6863576594,1521,6.72401424459,3089
MO,2020,4,12,5.739560513,1570,13.8876205788,1555,9.79403520173,3125
MO,2020,4,13,6.318983724,1722,14.4565119197,1594,10.2306905828,3316
MO,2020,4,14,4.96140619,1785,11.1219307832,1647,7.91781178588,3432
MO,2020,4,15,5.348689079,1724,14.4813389626,1658,9.82590182501,3382
MO,2020,4,16,5.495123707,1698,14.8854222766,1634,10.1000900524,3332
MO,2020,4,17,6.296302975,1558,12.5661870504,1668,9.53814012246,3226
MO,2020,4,18,8.203196749,1489,14.915961152,1493,11.5640811399,2982
MO,2020,4,19,9.783515001,1468,11.6030048243,1451,10.6879616381,2919
MO,2020,4,20,8.521001337,1578,13.9448108108,1480,11.1459974198,3058
MO,2020,4,21,6.787666896,1633,13.8861181703,1574,10.2715965205,3207
MO,2020,4,22,6.28863849,1704,14.2865594855,1555,10.1047683298,3259
MO,2020,4,23,6.108210212,1760,11.7762724014,1674,8.87126673649,3434
MO,2020,4,24,7.589603515,1589,18.1991052632,1710,13.0889208807,3299
MO,2020,4,25,6.114608354,1430,10.9777588652,1410,8.52905984022,2840
MO,2020,4,26,8.225532545,1352,15.1112424242,1320,11.6271556889,2672
MO,2020,4,27,7.023039306,1451,17.3388988095,1344,11.9835098508,2795
MO,2020,4,28,6.418227326,1478,15.978914405,1437,11.1313344727,2915
MO,2020,4,29,8.076638848,1559,15.6403100775,1419,11.6806850114,2978
MO,2020,4,30,8.785278533,1580,14.4163346614,1506,11.5332923144,3086
MO,2020,5,1,9.589486115,1440,18.5588209332,1586,14.2905320574,3026
MO,2020,5,2,9.329871229,1320,13.7579639781,1277,11.5072583836,2597
MO,2020,5,3,8.79110067,1381,9.60567911041,1259,9.17956819139,2640
MO,2020,5,4,8.256813398,1522,12.4454420836,1459,10.3068668204,2981
MO,2020,5,5,9.523249972,1520,13.1027395316,1409,11.2451689851,2929
MO,2020,5,6,9.016509538,1464,12.9616154396,1399,10.9442787159,2863
MO,2020,5,7,7.033961509,1507,13.4354507338,1431,10.1519094602,2938
MO,2020,5,8,9.783207427,1350,16.1188235294,1360,12.9627048068,2710
MO,2020,5,9,11.71255381,1300,16.2525826287,1301,13.9834409662,2601
MO,2020,5,10,11.57535303,1289,21.6770047923,1252,16.5526328436,2541
MO,2020,5,11,8.294859609,1389,15.8533070245,1267,11.9004894567,2656
MO,2020,5,12,6.039163906,1519,13.8528694405,1394,9.77836936945,2913
MO,2020,5,13,7.713580066,1405,17.6132639355,1489,12.807093985,2894
MO,2020,5,14,9.502126804,1420,16.4899530149,1277,12.8107860815,2697
MO,2020,5,15,8.542143328,1465,15.4540993789,1449,11.9791454961,2914
MO,2020,5,16,10.91681089,1317,11.667962563,1389,11.3023798751,2706
MO,2020,5,17,9.830965718,1284,19.7698015873,1260,14.7535023514,2544
MO,2020,5,18,9.109951031,1430,13.0776721557,1336,11.0263918924,2766
MO,2020,5,19,7.102366236,1458,17.388666186,1387,12.1171634348,2845
MO,2020,5,20,8.898515509,1455,17.1320350877,1425,12.9723923839,2880
MO,2020,5,21,13.68268524,1471,16.2493367347,1372,14.9213225424,2843
MO,2020,5,22,13.15775184,1370,24.5029452529,1443,18.9775577749,2813
MO,2020,5,23,11.92785339,1323,19.2659323367,1271,15.5233423419,2594
MO,2020,5,24,14.17089211,1334,23.2288243728,1395,18.8010920025,2729
MO,2020,5,25,13.99800453,1333,23.6286155004,1329,18.8060743946,2662
MO,2020,5,26,11.43080745,1449,19.7600812408,1354,15.454295396,2803
MO,2020,5,27,11.89194939,1503,17.0924606581,1398,14.3980902906,2901
MO,2020,5,28,13.97843167,1575,18.6898485846,1519,16.2915028702,3094
MO,2020,5,29,11.11643248,1466,19.863381201,1532,15.5861874635,2998
MO,2020,5,30,10.4520763,1416,19.5285443038,1422,14.999904877,2838
MO,2020,5,31,16.83865428,1516,21.076076975,1481,18.9326225854,2997
MO,2020,6,1,13.79854387,1607,25.0769674185,1596,19.41838901,3203
MO,2020,6,2,9.948947699,1549,15.9418238601,1601,12.9948507891,3150
MO,2020,6,3,10.91611374,1477,20.4581476323,1436,15.6199794006,2913
MO,2020,6,4,9.69833329,1464,14.1562312634,1401,11.8782687388,2865
MO,2020,6,5,13.01100566,1392,18.5683666191,1402,15.7996313095,2794
MO,2020,6,6,13.58302306,1300,22.6910437452,1303,18.1422819739,2603
MO,2020,6,7,12.34729431,1264,16.191593973,1261,14.2671603991,2525
MO,2020,6,8,9.639176867,1312,14.9416960537,1191,12.1622692966,2503
MO,2020,6,9,9.400339183,1415,18.6584313725,1377,13.9663825014,2792
MO,2020,6,10,8.758604966,1405,17.3748554913,1384,13.0342918527,2789
MO,2020,6,11,11.52551926,1377,19.1606421356,1386,15.3555157514,2763
MO,2020,6,12,14.69967322,1285,23.9516426513,1388,19.5039132389,2673
MO,2020,6,13,15.76992874,1263,23.1575315457,1268,19.4710272614,2531
MO,2020,6,14,13.8881212,1320,27.7275039246,1274,20.6851040802,2594
MO,2020,6,15,12.98349678,1387,21.058233945,1308,16.9025157825,2695
MO,2020,6,16,11.91167256,1411,17.3901348315,1335,14.575091035,2746
MO,2020,6,17,12.18199718,1447,22.417301013,1382,17.1820643052,2829
MO,2020,6,18,14.04970292,1481,19.4659446367,1445,16.7245044513,2926
MO,2020,6,19,13.36136138,1403,20.3195646164,1447,16.8941754443,2850
MO,2020,6,20,12.74785517,1380,24.9179025111,1354,18.7750110222,2734
MO,2020,6,21,17.59422874,1303,27.1428281363,1379,22.5038180642,2682
MO,2020,6,22,15.63209782,1411,26.2412650602,1328,20.7759364819,2739
MO,2020,6,23,13.03252979,1427,17.76665195,1359,15.3418162277,2786
MO,2020,6,24,14.24794682,1354,20.9972256098,1312,17.5694223534,2666
MO,2020,6,25,14.85465553,1379,22.3946404744,1349,18.5831891407,2728
MO,2020,6,26,14.34817138,1307,22.5930888889,1350,18.5373466292,2657
MO,2020,6,27,17.28297232,1302,25.791391635,1315,21.5583148493,2617
MO,2020,6,28,17.78571843,1371,22.8402237654,1296,20.2419010002,2667
MO,2020,6,29,14.7066484,1462,24.5358996416,1395,19.5060202873,2857
MO,2020,6,30,11.60962779,1370,23.9183007954,1383,17.7930258163,2753
MO,2020,7,1,14.07389277,1436,27.5898497268,1464,20.8971206958,2900
MO,2020,7,2,16.77267301,1373,22.8355426918,1382,19.8140109048,2755
MO,2020,7,3,14.1348771,1343,20.3812611276,1348,17.2638721462,2691
MO,2020,7,4,13.96236657,1293,23.1263588589,1332,18.6124380857,2625
MO,2020,7,5,18.707376,1330,23.7401804758,1219,21.114197756,2549
MO,2020,7,6,12.85346023,1471,25.589862164,1451,19.1780732369,2922
MO,2020,7,7,11.55355972,1458,23.1550762527,1377,17.1885820359,2835
MO,2020,7,8,14.89825419,1495,20.1972937771,1382,17.4437087292,2877
MO,2020,7,9,15.64819398,1495,22.4375254237,1475,19.02,2970
MO,2020,7,10,15.24793693,1425,25.9457038025,1499,20.7321888253,2924
MO,2020,7,11,14.93078387,1365,26.2248550725,1380,20.6086775893,2745
MO,2020,7,12,18.53842859,1330,19.4437240356,1348,18.9941187546,2678
MO,2020,7,13,10.55215687,1428,23.2581718062,1362,16.7548781399,2790
MO,2020,7,14,9.949809297,1468,25.0925174825,1430,17.4218840745,2898
MO,2020,7,15,11.38192385,1523,17.2957894737,1444,14.260124713,2967
MO,2020,7,16,16.4130365,1505,19.2540186246,1396,17.7801550957,2901
MO,2020,7,17,12.63037279,1368,22.5468417367,1428,17.6950071447,2796
MO,2020,7,18,12.29176516,1286,23.9327334852,1317,18.1815674206,2603
MO,2020,7,19,16.96058701,1346,23.0939177657,1289,19.9609146548,2635
MO,2020,7,20,12.94265577,1461,24.2367037552,1438,18.5448775716,2899
MO,2020,7,21,13.14657059,1493,19.0368987796,1393,15.9896846469,2886
MO,2020,7,22,12.7720504,1585,19.8095859213,1449,16.133088294,3034
MO,2020,7,23,16.41030207,1589,20.9601260783,1507,18.6249612368,3096
MO,2020,7,24,17.1446023,1458,21.3845377049,1525,19.3121857705,2983
MO,2020,7,25,15.60356932,1342,22.7963356428,1299,19.1413972084,2641
MO,2020,7,26,15.05161811,1372,29.9268555467,1253,22.1520647798,2625
MO,2020,7,27,16.74381708,1454,25.170255102,1372,20.8347841593,2826
MO,2020,7,28,12.76789016,1493,24.2778011611,1378,18.2923267185,2871
MO,2020,7,29,13.01621982,1492,17.4807404891,1472,15.2334176692,2964
MO,2020,7,30,14.75883456,1450,21.4884609774,1371,18.0294186856,2821
MO,2020,7,31,14.78859175,1335,23.307005814,1376,19.1122132004,2711
MS,2020,1,1,33.74169875,830,32.500383693,834,33.1195492563,1664
MS,2020,1,2,26.45942378,833,31.5901520913,789,28.9551972927,1622
MS,2020,1,3,21.24650124,846,37.9232229581,906,29.8704224024,1752
MS,2020,1,4,26.48170014,847,33.7719733656,826,30.0810818999,1673
MS,2020,1,5,35.91976259,800,28.9974854482,859,32.3355334973,1659
MS,2020,1,6,20.94438778,784,29.7002117061,803,25.3747133078,1587
MS,2020,1,7,22.32357579,811,34.1060507246,828,28.2759182219,1639
MS,2020,1,8,17.35302158,834,32.6075395859,821,24.9203685787,1655
MS,2020,1,9,23.32703384,890,35.0142857143,952,29.3673507696,1842
MS,2020,1,10,34.26728447,788,34.3719144144,888,34.3227208606,1676
MS,2020,1,11,25.37028201,780,31.6734096386,830,28.6197204769,1610
MS,2020,1,12,26.89429451,808,33.5119723618,796,30.17837903,1604
MS,2020,1,13,18.80479251,916,32.3720223464,895,25.5097459631,1811
MS,2020,1,14,18.92727525,701,26.9482900433,924,23.4881476617,1625
MS,2020,1,15,17.18638757,609,26.0264310345,580,21.4986038941,1189
MS,2020,1,16,25.3121374,772,31.1870963542,768,28.2419870603,1540
MS,2020,1,17,25.34356705,799,33.4053403756,852,29.503852255,1651
MS,2020,1,18,20.76531486,794,30.1303680982,815,25.5089558725,1609
MS,2020,1,19,28.76006318,792,31.5773366834,796,30.1722481351,1588
MS,2020,1,20,21.9158718,826,36.0476492083,821,28.9603097188,1647
MS,2020,1,21,18.16351702,853,29.0271395349,860,23.6175248208,1713
MS,2020,1,22,17.8817065,879,27.5900117371,852,22.660144433,1731
MS,2020,1,23,21.29774417,860,33.7057274827,866,27.5233024254,1726
MS,2020,1,24,26.15793907,786,36.0055172414,870,31.3314855731,1656
MS,2020,1,25,20.95445076,874,29.2541301627,799,24.918254611,1673
MS,2020,1,26,20.76095361,839,29.4185071575,978,25.4208806157,1817
MS,2020,1,27,15.18955255,827,29.0015346535,808,22.0152904947,1635
MS,2020,1,28,14.42746329,820,28.7738826185,886,21.878182824,1706
MS,2020,1,29,18.00951925,832,29.04925,840,23.5557954641,1672
MS,2020,1,30,20.67003572,840,32.1178791469,844,26.407553447,1684
MS,2020,1,31,24.78161642,829,34.1600346821,865,29.5704781654,1694
MS,2020,2,1,24.40717178,838,32.8926315789,836,28.6448327071,1674
MS,2020,2,2,21.11052542,571,34.557235023,868,29.221535799,1439
MS,2020,2,3,12.72439172,485,21.9989632829,463,17.2540611648,948
MS,2020,2,4,13.15577749,791,23.3805369128,745,18.1150520798,1536
MS,2020,2,5,17.71804123,827,24.5421316306,1018,21.4833117058,1845
MS,2020,2,6,23.63502723,366,32.4614268143,813,29.7214249077,1179
MS,2020,2,7,16.81433595,399,17.3381588448,277,17.0289793551,676
MS,2020,2,8,21.67434137,744,30.7594993742,799,26.3788399088,1543
MS,2020,2,9,26.62831757,737,32.7816817594,773,29.7783510259,1510
MS,2020,2,10,16.11749379,806,27.5328989038,821,21.8778180668,1627
MS,2020,2,11,13.95950396,766,29.8286498856,874,22.4165975813,1640
MS,2020,2,12,16.58832925,808,26.2853004005,749,21.2530892961,1557
MS,2020,2,13,23.68999988,879,32.3185714286,896,28.0456055744,1775
MS,2020,2,14,21.96457472,811,40.7563478261,920,31.9521144413,1731
MS,2020,2,15,20.90190524,782,31.2697954272,831,26.2433291368,1613
MS,2020,2,16,22.49506342,788,30.1002035623,786,26.292801763,1574
MS,2020,2,17,17.79013537,813,25.8303381643,828,21.8469835806,1641
MS,2020,2,18,17.11529086,894,32.103053961,871,24.5115184299,1765
MS,2020,2,19,18.46115206,868,27.6560652174,920,23.1923154296,1788
MS,2020,2,20,26.00652273,857,30.7613879408,879,28.4140840896,1736
MS,2020,2,21,28.71278561,840,31.5656293706,858,30.1543285703,1698
MS,2020,2,22,21.60433764,770,35.2413071895,1071,29.5376317125,1841
MS,2020,2,23,27.64141178,772,43.9251450189,793,35.8925302838,1565
MS,2020,2,24,23.46655503,836,32.6961124694,818,28.0311124577,1654
MS,2020,2,25,25.29929387,864,31.9562980769,832,28.564994047,1696
MS,2020,2,26,19.95036602,847,30.1865321564,793,24.8999268408,1640
MS,2020,2,27,27.49709633,861,29.1098259861,862,28.3039291585,1723
MS,2020,2,28,33.36133894,844,35.6788318777,916,34.5674886735,1760
MS,2020,2,29,28.40980866,784,35.8282470588,850,32.2688494427,1634
MS,2020,3,1,33.70017622,794,37.8384768212,755,35.7172304188,1549
MS,2020,3,2,16.94281482,874,26.7419828641,817,21.6772443245,1691
MS,2020,3,3,16.9882284,841,29.3292093541,898,23.3609718714,1739
MS,2020,3,4,22.64878821,817,30.3466358382,865,26.6075505158,1682
MS,2020,3,5,29.00166669,840,29.6733407572,898,29.3487111735,1738
MS,2020,3,6,31.73538159,760,35.7547921478,866,33.8761008662,1626
MS,2020,3,7,32.34613183,698,35.5769589041,730,33.9977451102,1428
MS,2020,3,8,40.70169798,695,34.3108479139,743,37.3996106371,1438
MS,2020,3,9,22.43265931,722,38.0277044476,697,30.0928048075,1419
MS,2020,3,10,19.89320616,786,37.5315243902,820,28.8990722551,1606
MS,2020,3,11,27.06954128,872,41.5157678356,827,34.1013419636,1699
MS,2020,3,12,23.2683049,879,39.1530914826,951,31.5231857962,1830
MS,2020,3,13,28.46489791,784,36.0478301887,848,32.405048996,1632
MS,2020,3,14,33.60468801,753,36.5014751958,766,35.0654773348,1519
MS,2020,3,15,20.83963545,768,37.3554417414,781,29.1668431411,1549
MS,2020,3,16,19.1299882,847,28.3271012806,859,23.7608909762,1706
MS,2020,3,17,16.70806658,812,32.3928817451,871,24.8254011069,1683
MS,2020,3,18,14.40233121,815,29.4347779112,833,22.0006492331,1648
MS,2020,3,19,18.41456686,843,24.2122196262,856,21.3355737863,1699
MS,2020,3,20,15.51913962,802,27.3485614849,862,21.6471213794,1664
MS,2020,3,21,12.25121785,739,25.9944806008,799,19.3909232712,1538
MS,2020,3,22,13.35943932,749,22.3910916442,742,17.8540644203,1491
MS,2020,3,23,8.03034787,805,20.9685714286,798,14.4712102529,1603
MS,2020,3,24,7.796803368,829,21.4167597087,824,14.5861826933,1653
MS,2020,3,25,8.961334163,802,19.9250240964,830,14.5372303914,1632
MS,2020,3,26,10.05669209,789,23.0643980344,814,16.6619775789,1603
MS,2020,3,27,9.346342835,741,24.2910479798,792,17.0672863932,1533
MS,2020,3,28,7.8180552,725,18.7168516129,775,13.4491000133,1500
MS,2020,3,29,11.14093026,688,23.5723618785,724,17.51512041,1412
MS,2020,3,30,10.16506144,733,22.5295188557,769,16.4954660689,1502
MS,2020,3,31,8.972198296,746,19.6114136126,764,14.3552184959,1510
MS,2020,4,1,9.024944918,726,23.307617866,806,16.5391971348,1532
MS,2020,4,2,10.2173938,706,19.2273743017,716,14.7540647136,1422
MS,2020,4,3,8.608393636,691,20.8027443106,747,14.9430111283,1438
MS,2020,4,4,6.984254715,691,19.2241193182,704,13.1612186438,1395
MS,2020,4,5,5.012794788,687,17.945094086,744,11.7365059534,1431
MS,2020,4,6,10.17185691,727,18.2982106599,788,14.3986336459,1515
MS,2020,4,7,10.3192361,720,20.5413043478,736,15.4864354341,1456
MS,2020,4,8,9.72709777,634,23.4286118252,778,17.2765155709,1412
MS,2020,4,9,9.884248447,652,15.910777605,643,12.8765714189,1295
MS,2020,4,10,6.947679158,642,24.5794729345,702,16.1571428716,1344
MS,2020,4,11,8.577812027,649,16.0913978495,651,12.3403846196,1300
MS,2020,4,12,10.43281903,674,14.6190247253,728,12.6065406749,1402
MS,2020,4,13,6.398069393,663,19.9494563662,699,13.3528560995,1362
MS,2020,4,14,6.402236317,711,21.4732798834,686,13.8029062429,1397
MS,2020,4,15,6.17974025,693,19.3077360931,773,13.1019372396,1466
MS,2020,4,16,8.897582414,637,19.0076712329,657,14.0307573398,1294
MS,2020,4,17,9.660503347,596,22.3725722543,692,16.4902794991,1288
MS,2020,4,18,7.591724673,632,22.149847793,657,15.0119627567,1289
MS,2020,4,19,10.99312395,605,13.3266666667,627,12.1807305112,1232
MS,2020,4,20,10.88124229,644,19.5011912226,638,15.1710452689,1282
MS,2020,4,21,7.697129247,627,21.3154231975,638,14.5654861959,1265
MS,2020,4,22,10.55775511,686,24.0194444444,666,17.1890310691,1352
MS,2020,4,23,11.24908442,699,21.9668342391,736,16.7461324109,1435
MS,2020,4,24,9.715564221,638,23.6122160665,722,17.0930514507,1360
MS,2020,4,25,9.442470229,587,22.5672385621,612,16.1416847577,1199
MS,2020,4,26,11.40639182,582,23.9297495826,599,17.7582049443,1181
MS,2020,4,27,15.51576289,616,25.3699671593,609,20.4147101553,1225
MS,2020,4,28,8.588192603,592,23.0725123153,609,15.9328642972,1201
MS,2020,4,29,10.81377933,598,19.8713592233,618,15.4170559534,1216
MS,2020,4,30,13.08084478,651,21.9460923077,650,17.5100614541,1301
MS,2020,5,1,16.6681426,603,28.3555090656,717,23.0165075665,1320
MS,2020,5,2,12.06885928,561,24.6602539683,630,18.7292947574,1191
MS,2020,5,3,10.944734,545,27.0380453752,573,19.1929159481,1118
MS,2020,5,4,14.41732113,601,22.9097157191,598,18.6528940777,1199
MS,2020,5,5,14.60995047,606,27.0040432612,601,20.7813255881,1207
MS,2020,5,6,15.42054329,589,25.3552475248,606,20.4585606676,1195
MS,2020,5,7,12.17763664,622,26.9397645212,637,19.6466401827,1259
MS,2020,5,8,12.13684501,542,26.83592,625,20.0091002531,1167
MS,2020,5,9,15.55147334,543,25.854434629,566,20.8097926272,1109
MS,2020,5,10,14.54616826,535,30.1547576302,557,22.5076923252,1092
MS,2020,5,11,13.2637231,556,28.8332918149,562,21.0902862644,1118
MS,2020,5,12,8.721609613,584,25.1515566836,591,16.9855234162,1175
MS,2020,5,13,10.37839192,541,25.1899198718,624,18.3117768487,1165
MS,2020,5,14,10.55215584,552,22.9376744186,516,16.5361704342,1068
MS,2020,5,15,10.80008628,579,36.2563297045,643,24.1948199314,1222
MS,2020,5,16,8.228820238,534,32.6035971223,556,20.6621926671,1090
MS,2020,5,17,17.28074654,509,28.8199271403,549,23.2684687985,1058
MS,2020,5,18,14.26003525,565,33.2273357016,563,23.7268704931,1128
MS,2020,5,19,12.86951136,573,24.0559936407,629,18.7233361142,1202
MS,2020,5,20,13.5778993,576,28.243965812,585,20.967777775,1161
MS,2020,5,21,17.39988119,589,29.114295082,610,23.3596747464,1199
MS,2020,5,22,19.12732083,586,31.1283728278,633,25.359204271,1219
MS,2020,5,23,13.70362972,540,27.7905035971,556,20.8498905555,1096
MS,2020,5,24,21.38676799,526,28.1700970874,515,24.7425936241,1041
MS,2020,5,25,25.36012646,553,35.136091954,522,30.1071534255,1075
MS,2020,5,26,18.29005286,568,23.9669491525,590,21.1824266187,1158
MS,2020,5,27,10.82658028,579,24.6313322091,593,17.8114078346,1172
MS,2020,5,28,16.26483052,619,27.3434579439,642,21.9051785027,1261
MS,2020,5,29,19.55755598,581,27.3076848875,622,23.5646882996,1203
MS,2020,5,30,19.11780755,561,24.6170860927,604,21.9689356528,1165
MS,2020,5,31,24.01325944,543,35.2758573854,589,29.8733921165,1132
MS,2020,6,1,15.80357273,585,29.4116534181,629,22.8542175017,1214
MS,2020,6,2,11.55927978,597,25.7351948052,616,18.7582605348,1213
MS,2020,6,3,12.85848089,599,27.1310381679,655,20.3134450184,1254
MS,2020,6,4,13.94805545,576,29.3471806854,642,22.0648357465,1218
MS,2020,6,5,22.5210274,584,28.0170116861,599,25.3038630614,1183
MS,2020,6,6,15.30386616,538,31.4810645161,620,23.9652331555,1158
MS,2020,6,7,13.16055991,500,29.2697977941,544,21.5546455508,1044
MS,2020,6,8,18.1874911,562,27.0723560209,573,22.672977972,1135
MS,2020,6,9,16.53861412,570,24.4230831974,613,20.6241420527,1183
MS,2020,6,10,14.63649755,611,24.9509105691,615,19.8105301819,1226
MS,2020,6,11,16.77133912,575,35.8925326797,612,26.6299494473,1187
MS,2020,6,12,18.85722941,545,36.5574092409,606,28.1763510238,1151
MS,2020,6,13,18.7751114,538,30.3223758865,564,24.6849636417,1102
MS,2020,6,14,21.55525214,575,33.537090301,598,27.6636402221,1173
MS,2020,6,15,17.39867595,574,34.6166830065,612,26.2835160163,1186
MS,2020,6,16,14.83767127,584,28.2164685908,589,21.5555839912,1173
MS,2020,6,17,15.89518388,598,29.1628459119,636,22.733298185,1234
MS,2020,6,18,19.64388692,584,36.2106158833,617,28.1548542559,1201
MS,2020,6,19,22.59071309,575,44.432433281,637,34.0702310452,1212
MS,2020,6,20,22.11093353,557,31.7911937716,578,27.0406167191,1135
MS,2020,6,21,22.65059039,576,37.6442130366,629,30.4771369831,1205
MS,2020,6,22,19.36473767,610,30.4684384858,634,25.0236977321,1244
MS,2020,6,23,14.13617312,601,27.1044205298,604,20.6364398715,1205
MS,2020,6,24,17.29096433,591,33.7665849387,571,25.3869878821,1162
MS,2020,6,25,20.24167454,621,27.1698504983,602,23.6519459439,1223
MS,2020,6,26,22.11586973,598,36.7929084967,612,29.5392976021,1210
MS,2020,6,27,18.62528011,625,35.864648318,654,27.4404066214,1279
MS,2020,6,28,19.61237621,606,30.1338522013,636,25.0001851717,1242
MS,2020,6,29,16.56936903,634,26.7847683109,669,21.8142670491,1303
MS,2020,6,30,18.06661564,588,29.9350877193,627,24.1913333303,1215
MS,2020,7,1,20.84958326,576,34.230671875,640,27.8922614784,1216
MS,2020,7,2,25.47185001,600,30.4256879195,596,27.9404849548,1196
MS,2020,7,3,17.65654873,565,38.0364774624,599,28.1441581035,1164
MS,2020,7,4,20.34720879,541,26.9855267703,579,23.778982103,1120
MS,2020,7,5,28.23460829,549,29.593,540,28.9081909561,1089
MS,2020,7,6,22.45452956,574,34.1819185059,589,28.3938520786,1163
MS,2020,7,7,12.14396666,600,30.9754692557,618,21.6988669918,1218
MS,2020,7,8,13.73490122,608,27.0432496075,637,20.5440722424,1245
MS,2020,7,9,18.71760126,617,33.925226209,641,26.4664785194,1258
MS,2020,7,10,22.2504247,565,33.4279969419,654,28.2472518093,1219
MS,2020,7,11,19.48771477,547,33.2076320583,549,26.3601915869,1096
MS,2020,7,12,22.30879499,556,33.5180854701,585,28.0558895832,1141
MS,2020,7,13,17.43479775,569,33.9035833333,600,25.8875533959,1169
MS,2020,7,14,14.89093428,578,35.2372920065,613,25.3630730595,1191
MS,2020,7,15,18.89835129,558,33.8585227273,616,26.7479812775,1174
MS,2020,7,16,18.30054354,552,31.0002276708,571,24.7578183741,1123
MS,2020,7,17,17.25478663,539,39.1417525773,582,28.6180463814,1121
MS,2020,7,18,24.22932075,530,39.5243933824,544,31.9765456215,1074
MS,2020,7,19,24.10774423,532,36.8665654649,527,30.4570348729,1059
MS,2020,7,20,21.45268247,589,35.3300990099,606,28.4901003973,1195
MS,2020,7,21,17.08138111,572,30.7318046358,604,24.0923129209,1176
MS,2020,7,22,17.27703255,583,30.5565266559,619,24.1156405796,1202
MS,2020,7,23,18.38951206,574,34.9486454849,598,26.8386262137,1172
MS,2020,7,24,20.95390091,505,36.9495214521,606,29.6787848421,1111
MS,2020,7,25,17.44475994,500,33.2588910134,523,25.5295991887,1023
MS,2020,7,26,25.78822173,523,35.301744186,516,30.512935481,1039
MS,2020,7,27,19.56990981,554,38.0895454545,572,28.9777531392,1126
MS,2020,7,28,14.53966488,567,25.2060558464,573,19.9009298131,1140
MS,2020,7,29,19.23598608,578,31.8982914573,597,25.6695148547,1175
MS,2020,7,30,23.0338325,561,32.3123255814,602,27.8366294347,1163
MS,2020,7,31,22.16606803,529,37.7278863233,563,30.1892399156,1092
MT,2020,1,1,67.95266682,120,43.0728571429,119,55.5648117925,239
MT,2020,1,2,36.29926848,123,108.505877193,114,71.0315612786,237
MT,2020,1,3,50.11057374,122,59.585,118,54.7688333178,240
MT,2020,1,4,36.10356544,115,42.5520740741,135,39.5857601024,250
MT,2020,1,5,71.12870418,108,43.0752252252,111,56.9098175865,219
MT,2020,1,6,45.26833359,120,38.389537037,108,42.0099562754,228
MT,2020,1,7,25.55616007,125,52.0635294118,119,38.4839344621,244
MT,2020,1,8,23.45320021,125,57.8486666667,120,40.2999592908,245
MT,2020,1,9,47.34631968,125,103.384222222,135,76.4429229231,260
MT,2020,1,10,36.14318994,116,39.7468852459,122,37.9904623237,238
MT,2020,1,11,42.98524225,124,26.2689516129,124,34.6270969315,248
MT,2020,1,12,75.94335918,128,76.737804878,123,76.3326692233,251
MT,2020,1,13,21.96210952,128,44.8354310345,116,32.8363115515,244
MT,2020,1,14,13.03567031,97,32.3103305785,121,23.7339909178,218
MT,2020,1,15,67.5696737,92,36.6375,76,53.5765475024,168
MT,2020,1,16,28.35992485,133,31.4595762712,118,29.8171314942,251
MT,2020,1,17,21.04389324,131,40.3945384615,130,30.6821456492,261
MT,2020,1,18,24.5485,120,30.8185217391,115,27.6168085106,235
MT,2020,1,19,25.14467746,124,43.5679259259,135,34.747528977,259
MT,2020,1,20,40.09241719,120,58.1233858268,127,49.363401064,247
MT,2020,1,21,42.25881401,118,31.9777037037,135,36.77284606,253
MT,2020,1,22,25.77965531,145,37.9701550388,129,31.518978175,274
MT,2020,1,23,41.28959407,148,42.5267515924,157,41.926425975,305
MT,2020,1,24,42.99843704,128,30.9670833333,144,36.6288968424,272
MT,2020,1,25,47.03962112,132,53.96828125,128,50.4506537994,260
MT,2020,1,26,38.02818165,121,24.9180128205,156,30.6448374717,277
MT,2020,1,27,40.0184091,132,69.6468571429,105,53.1449367139,237
MT,2020,1,28,25.90328339,134,47.5241549296,142,37.0270651241,276
MT,2020,1,29,30.07364947,137,50.288828125,128,39.8379621788,265
MT,2020,1,30,34.35200012,150,61.7705147059,136,47.3901748881,286
MT,2020,1,31,38.80423637,144,48.304,135,43.400896191,279
MT,2020,2,1,41.73006347,158,28.7711034483,145,35.5285809514,303
MT,2020,2,2,39.86311846,93,19.513597561,164,26.8774319719,257
MT,2020,2,3,33.37324645,77,15.3959722222,72,24.686241454,149
MT,2020,2,4,18.05733857,124,41.6001869159,107,28.9624674575,231
MT,2020,2,5,21.53140486,121,32.9709395973,149,27.8443332891,270
MT,2020,2,6,48.96749946,52,47.1286842105,114,47.704698626,166
MT,2020,2,7,14.16015368,65,17.3886666667,60,15.7098399136,125
MT,2020,2,8,28.45267718,127,52.2407352941,136,40.7537262428,263
MT,2020,2,9,44.32433931,106,39.2256666667,120,41.6170794994,226
MT,2020,2,10,25.00594785,116,27.7295049505,101,26.2735942424,217
MT,2020,2,11,26.85507703,130,37.888677686,121,32.1740638004,251
MT,2020,2,12,54.57270787,144,55.7133070866,127,55.1072322261,271
MT,2020,2,13,35.98509719,155,35.3160839161,143,35.664060619,298
MT,2020,2,14,43.0394571,129,43.4558666667,150,43.2633332111,279
MT,2020,2,15,28.0041321,121,32.4342857143,105,30.0623893102,226
MT,2020,2,16,53.51562946,135,70.2174782609,115,61.1984799084,250
MT,2020,2,17,43.87565544,122,30.2925,116,37.255293965,238
MT,2020,2,18,38.24395502,134,51.6142857143,119,44.5327666904,253
MT,2020,2,19,37.47040569,148,38.5192248062,129,37.9588449174,277
MT,2020,2,20,30.06789843,138,64.2913385827,127,46.4693206918,265
MT,2020,2,21,37.08579305,126,52.4438518519,135,45.0296165682,261
MT,2020,2,22,43.29488371,129,42.8085051546,194,43.0027554136,323
MT,2020,2,23,11.50042724,117,26.0937313433,134,19.2912748489,251
MT,2020,2,24,40.20477647,134,34.1831304348,115,37.4236949678,249
MT,2020,2,25,19.43918521,135,34.4593006993,143,27.1653597243,278
MT,2020,2,26,46.04328447,137,40.5113740458,131,43.3392536283,268
MT,2020,2,27,54.41094631,148,58.2971724138,145,56.3341640064,293
MT,2020,2,28,27.27613111,137,32.2879230769,130,29.716329446,267
MT,2020,2,29,14.20509251,108,32.2859558824,136,24.2829507831,244
MT,2020,3,1,46.92764176,106,35.8158181818,110,41.2688427156,216
MT,2020,3,2,23.49628322,113,49.1883333333,108,36.0516742256,221
MT,2020,3,3,12.00961239,129,63.9921311475,122,37.2760159295,251
MT,2020,3,4,31.00114861,148,43.7957936508,126,36.8848174974,274
MT,2020,3,5,67.32911786,136,50.4834782609,138,58.8448176239,274
MT,2020,3,6,59.19517145,116,38.9816521739,115,49.1321640182,231
MT,2020,3,7,55.18596538,119,41.3603076923,130,47.967750523,249
MT,2020,3,8,52.54609516,105,37.0601818182,110,44.6230697293,215
MT,2020,3,9,20.61225541,133,73.05536,125,46.020736316,258
MT,2020,3,10,18.19642851,154,65.944379562,137,40.6757044348,291
MT,2020,3,11,32.78815657,179,33.7788957055,163,33.2603509533,342
MT,2020,3,12,36.67475672,185,55.2232222222,180,45.8219451868,365
MT,2020,3,13,39.5918473,157,51.727251462,171,45.9185366649,328
MT,2020,3,14,27.07259287,135,39.4123404255,141,33.3765943386,276
MT,2020,3,15,12.92191772,146,50.7562589928,139,31.3744560952,285
MT,2020,3,16,19.99942308,156,36.8209580838,167,28.6966253885,323
MT,2020,3,17,8.409729825,148,53.0975,148,30.7536149125,296
MT,2020,3,18,19.11489813,147,49.5738853503,157,34.8453619247,304
MT,2020,3,19,29.14659742,144,42.6201470588,136,35.6908929589,280
MT,2020,3,20,26.81746616,146,44.414601227,163,36.1000972795,309
MT,2020,3,21,27.14031042,129,25.9849640288,139,26.5410822544,268
MT,2020,3,22,8.72717748,124,59.9205691057,123,34.2202429454,247
MT,2020,3,23,13.86649969,160,37.6210596026,151,25.4000641492,311
MT,2020,3,24,10.87825005,160,20.6082119205,151,15.6024437556,311
MT,2020,3,25,20.43816085,174,26.6315432099,162,23.4242559164,336
MT,2020,3,26,15.77914267,175,20.0459574468,188,17.9889530778,363
MT,2020,3,27,14.00822777,158,26.2021176471,170,20.3282316697,328
MT,2020,3,28,21.00041956,167,26.4738255034,149,23.5812343877,316
MT,2020,3,29,15.36412885,155,40.2626751592,157,27.8932050377,312
MT,2020,3,30,5.054000042,150,26.241862069,145,15.4683729027,295
MT,2020,3,31,28.14423511,170,20.3848466258,163,24.3460960021,333
MT,2020,4,1,23.87030277,165,36.4651298701,154,29.9505641287,319
MT,2020,4,2,8.550789463,152,37.0783544304,158,23.0906451561,310
MT,2020,4,3,24.27799992,135,60.9749253731,134,42.558252748,269
MT,2020,4,4,14.45274654,142,51.5911029412,136,32.6211511104,278
MT,2020,4,5,17.12020424,147,30.8243181818,132,23.6038710512,279
MT,2020,4,6,31.39399991,155,29.7857777778,135,30.6453447795,290
MT,2020,4,7,38.37340029,150,46.2683453237,139,42.1706229879,289
MT,2020,4,8,20.99916066,131,33.6853488372,129,27.2934617172,260
MT,2020,4,9,13.05612902,124,43.2932758621,116,27.6707499937,240
MT,2020,4,10,31.68171616,134,37.1972932331,133,34.4291759005,267
MT,2020,4,11,31.35227634,123,32.8090697674,129,32.0980158326,252
MT,2020,4,12,19.57062552,112,51.9565217391,115,35.9775773491,227
MT,2020,4,13,12.31296869,128,11.5803125,128,11.946640595,256
MT,2020,4,14,19.09183193,131,26.1878151261,119,22.4695199313,250
MT,2020,4,15,55.83448257,145,16.910530303,132,37.2858843778,277
MT,2020,4,16,15.67352001,125,13.081,120,14.4037142908,245
MT,2020,4,17,21.51846147,104,50.471147541,122,37.1477875791,226
MT,2020,4,18,20.85804155,97,75.2383962264,106,49.2536947308,203
MT,2020,4,19,18.6025667,113,44.8001941748,103,31.0949538755,216
MT,2020,4,20,22.43187049,123,52.9661666667,120,37.5105352686,243
MT,2020,4,21,18.28599952,125,30.100952381,105,23.6797823478,230
MT,2020,4,22,29.29255859,129,17.5930769231,130,23.4202318846,259
MT,2020,4,23,14.33181802,132,44.9118309859,142,30.1798539366,274
MT,2020,4,24,12.73276764,112,24.1309230769,130,18.8557437012,242
MT,2020,4,25,27.07145587,103,25.5804065041,123,26.2599555514,226
MT,2020,4,26,24.95165157,109,44.2891176471,102,34.2996209532,211
MT,2020,4,27,27.95180226,111,48.0436036036,111,37.9977029318,222
MT,2020,4,28,13.83657125,105,74.8061702128,94,42.6362813128,199
MT,2020,4,29,16.84698446,126,35.7291964286,112,25.7327312687,238
MT,2020,4,30,41.95600027,120,20.9090322581,124,31.2600001328,244
MT,2020,5,1,32.50681061,116,26.4544525547,137,29.2294467619,253
MT,2020,5,2,37.05523446,107,28.7285849057,106,32.9114558085,213
MT,2020,5,3,29.51218156,110,46.7655238095,105,37.938232426,215
MT,2020,5,4,16.30112923,124,37.6556880734,109,26.2910301482,233
MT,2020,5,5,7.312295194,122,33.857768595,121,20.5304115789,243
MT,2020,5,6,11.06593464,123,16.1157024793,121,13.5701227898,244
MT,2020,5,7,26.43007327,136,28.7871969697,132,27.5910446445,268
MT,2020,5,8,28.33408644,115,25.8807936508,126,27.0514520357,241
MT,2020,5,9,31.42518887,106,35.1451376147,109,33.3111163731,215
MT,2020,5,10,52.73720004,100,38.1438,100,45.44050002,200
MT,2020,5,11,13.53075478,106,19.6167676768,99,16.4698536911,205
MT,2020,5,12,20.83517842,112,49.3214634146,123,35.7450212044,235
MT,2020,5,13,22.74550497,109,44.2061261261,111,33.573363826,220
MT,2020,5,14,19.03615346,117,86.3763461538,104,50.7256559042,221
MT,2020,5,15,35.8670896,134,39.7190551181,127,37.741417649,261
MT,2020,5,16,7.674326844,104,41.4171304348,115,25.3931506474,219
MT,2020,5,17,16.16196247,107,24.0675,112,20.2049770972,219
MT,2020,5,18,18.88376073,117,14.2019834711,121,16.5035294345,238
MT,2020,5,19,25.6333332,117,23.038984375,128,24.2779183037,245
MT,2020,5,20,10.83686966,115,18.5447826087,115,14.6908261343,230
MT,2020,5,21,20.2484615,117,32.604137931,116,26.3997853884,233
MT,2020,5,22,15.35365386,104,32.558173913,115,24.3879908742,219
MT,2020,5,23,24.29670124,97,65.4534042553,94,44.5518325669,191
MT,2020,5,24,20.47010747,93,63.6787878788,99,42.7495833058,192
MT,2020,5,25,10.72697459,119,55.8826168224,107,32.1059733461,226
MT,2020,5,26,20.11689651,116,29.8192920354,113,24.9045414636,229
MT,2020,5,27,29.41185154,135,25.2587155963,109,27.5565572045,244
MT,2020,5,28,36.35241952,124,30.9845736434,129,33.6154546264,253
MT,2020,5,29,15.37446428,112,27.871031746,126,21.990294115,238
MT,2020,5,30,30.38000035,107,41.6040594059,101,35.8301444108,208
MT,2020,5,31,55.71327415,113,31.4677868852,122,43.1262552296,235
MT,2020,6,1,29.46727982,136,67.1762015504,129,47.8236983227,265
MT,2020,6,2,17.30659073,132,20.8262878788,132,19.0664393044,264
MT,2020,6,3,16.6649219,128,45.3936283186,113,30.135228229,241
MT,2020,6,4,20.6844001,125,56.1089147287,129,38.6755906004,254
MT,2020,6,5,10.16991292,115,58.1977941176,136,36.1929879912,251
MT,2020,6,6,18.98397967,98,24.0783783784,111,21.6896172615,209
MT,2020,6,7,40.26543132,116,23.4800877193,114,31.9457392744,230
MT,2020,6,8,18.32294119,119,52.8719266055,109,34.8397807088,228
MT,2020,6,9,14.74312012,125,41.4081355932,118,27.6915638477,243
MT,2020,6,10,21.11738501,130,30.1966929134,127,25.6040468922,257
MT,2020,6,11,31.23318939,116,42.6904385965,114,36.9119998663,230
MT,2020,6,12,14.10397951,98,50.5437623762,101,32.5985426733,199
MT,2020,6,13,34.88528831,104,39.746635514,107,37.3505212523,211
MT,2020,6,14,35.49798065,104,56.4069827586,116,46.5227272164,220
MT,2020,6,15,42.7905503,109,39.842,105,41.3438316949,214
MT,2020,6,16,30.18250046,124,28.8004273504,117,29.5115355064,241
MT,2020,6,17,33.55135657,118,24.3196363636,110,29.0974564704,228
MT,2020,6,18,40.81696407,112,54.1636363636,121,47.7480685658,233
MT,2020,6,19,21.24876063,121,59.1887128713,101,38.5097298929,222
MT,2020,6,20,28.18639363,122,41.96816,125,35.1609717525,247
MT,2020,6,21,16.96400023,115,69.6195327103,107,42.3430181372,222
MT,2020,6,22,21.31957253,117,36.3163888889,108,28.5180443823,225
MT,2020,6,23,35.99403078,129,49.1811666667,120,42.3492769904,249
MT,2020,6,24,38.34872222,133,31.14832,125,34.8601552529,258
MT,2020,6,25,24.27525434,118,25.0356716418,134,24.6796032227,252
MT,2020,6,26,24.779273,110,39.8334108527,129,32.904728159,239
MT,2020,6,27,26.46964304,112,55.3446666667,120,41.4050000883,232
MT,2020,6,28,32.83803056,132,53.304,115,42.3667207851,247
MT,2020,6,29,51.53673771,141,37.6745138889,144,44.5326667267,285
MT,2020,6,30,39.9100795,126,40.9677272727,132,40.4512016163,258
MT,2020,7,1,56.82383342,120,71.3079699248,133,64.4380237565,253
MT,2020,7,2,32.08157907,133,45.1748818898,127,38.4771539089,260
MT,2020,7,3,48.21607991,125,85.3548387097,155,68.7750356741,280
MT,2020,7,4,20.77102031,98,45.107734375,128,34.5546459751,226
MT,2020,7,5,21.4064866,111,47.9431313131,99,33.9166191076,210
MT,2020,7,6,17.25013389,149,46.9245384615,130,31.0769173821,279
MT,2020,7,7,31.07453933,141,37.4345454545,154,34.3946781204,295
MT,2020,7,8,40.15960575,152,82.2609558824,136,60.0407988681,288
MT,2020,7,9,31.23808953,157,69.1458783784,148,49.6326887089,305
MT,2020,7,10,26.40371208,132,32.4893377483,151,29.6508127016,283
MT,2020,7,11,24.8509398,117,45.4849166667,120,35.2985230236,237
MT,2020,7,12,57.83433056,127,52.8513084112,107,55.5557691501,234
MT,2020,7,13,74.00978585,140,49.287972028,143,61.5178445901,283
MT,2020,7,14,35.69175624,131,50.01592,125,42.6859768259,256
MT,2020,7,15,31.64092188,141,53.1276978417,139,42.3075713753,280
MT,2020,7,16,25.45545419,143,41.7229787234,141,33.5319364407,284
MT,2020,7,17,30.92705011,122,34.5377165354,127,32.7686349937,249
MT,2020,7,18,33.82839274,112,35.0748780488,123,34.4808084548,235
MT,2020,7,19,29.59499981,130,47.2382926829,123,38.1725690723,253
MT,2020,7,20,17.40688298,154,70.3666901408,142,42.8132769558,296
MT,2020,7,21,28.48932874,149,57.36,134,42.1595405734,283
MT,2020,7,22,39.11932494,163,59.4948322148,149,48.849935786,312
MT,2020,7,23,27.95143724,167,55.8308974359,156,41.4164396876,323
MT,2020,7,24,19.06580873,136,54.5151265823,158,38.1168026778,294
MT,2020,7,25,26.6000807,124,62.9464220183,109,43.6033047502,233
MT,2020,7,26,26.58942615,122,67.201056338,142,48.4335605693,264
MT,2020,7,27,25.40704202,142,31.3235036496,137,28.3122579457,279
MT,2020,7,28,37.69363057,146,45.1911971831,142,41.3903474417,288
MT,2020,7,29,33.69263131,152,57.6410144928,138,45.0887584797,290
MT,2020,7,30,21.36384622,143,77.7132894737,152,50.3981356253,295
MT,2020,7,31,44.57075904,145,48.8955172414,145,46.7331381407,290
NC,2020,1,1,27.68058082,3426,27.5859580921,3627,27.6319211526,7053
NC,2020,1,2,21.58008074,3468,24.5179438098,3239,22.9988579106,6707
NC,2020,1,3,19.57354531,3554,25.241399177,3645,22.4432949065,7199
NC,2020,1,4,19.23530085,3524,27.7642128852,3570,23.5274091056,7094
NC,2020,1,5,20.51479822,3345,22.7882571429,3500,21.6772680856,6845
NC,2020,1,6,15.21236892,3529,26.6187125482,3371,20.784946365,6900
NC,2020,1,7,14.20721474,3637,23.1566270718,3620,18.6714386123,7257
NC,2020,1,8,17.47174541,3701,24.4531087797,3622,20.9247698706,7323
NC,2020,1,9,19.32290566,3710,26.1625293132,3582,22.6826878769,7292
NC,2020,1,10,19.81693229,3501,25.2760384615,3640,22.5996162929,7141
NC,2020,1,11,19.79171151,3459,23.2930775789,3519,21.557447709,6978
NC,2020,1,12,20.96745674,3586,28.3445384396,3499,24.6107042865,7085
NC,2020,1,13,13.73381636,3899,25.5356233766,3850,19.5974061153,7749
NC,2020,1,14,11.79141651,3078,22.5747314838,3929,17.8378906833,7007
NC,2020,1,15,15.75423357,2903,15.6068547419,2499,15.6860551747,5402
NC,2020,1,16,19.89644993,3552,27.157907812,3341,23.4160394823,6893
NC,2020,1,17,22.45126262,3469,26.8666134454,3570,24.6906151483,7039
NC,2020,1,18,19.15528185,3406,24.917136703,3482,22.0679965129,6888
NC,2020,1,19,20.87069941,3460,25.528159862,3478,23.2054713114,6938
NC,2020,1,20,18.49351948,3546,27.3903601757,3415,22.858224404,6961
NC,2020,1,21,13.99887819,3628,21.9785646994,3609,17.9782465211,7237
NC,2020,1,22,15.36531197,3718,22.5314552444,3642,18.9113844979,7360
NC,2020,1,23,19.95968839,3594,26.0009779268,3579,22.9740164608,7173
NC,2020,1,24,20.21937668,3401,28.138438914,3536,24.2559636858,6937
NC,2020,1,25,17.27596304,3728,23.9196359366,3406,20.4478651827,7134
NC,2020,1,26,19.98190827,3684,28.6205072984,4179,24.5731209547,7863
NC,2020,1,27,13.52814297,3554,21.882617708,3377,17.5987043883,6931
NC,2020,1,28,12.31033722,3588,22.9953187872,3529,17.6085387025,7117
NC,2020,1,29,14.61456112,3600,22.3061661972,3550,18.4334699345,7150
NC,2020,1,30,16.85342055,3745,24.4962426778,3585,20.591417457,7330
NC,2020,1,31,22.51483389,3703,28.0134106963,3964,25.3577135639,7667
NC,2020,2,1,21.19049628,3647,31.5523164627,3596,26.3349261264,7243
NC,2020,2,2,15.73305479,2429,25.8582292707,4004,22.0351220402,6433
NC,2020,2,3,21.05431754,2154,19.3003412463,2022,20.2050502828,4176
NC,2020,2,4,12.0768128,3307,19.5041876047,2985,15.600448177,6292
NC,2020,2,5,14.20881714,3686,21.9063192439,3809,18.1207298169,7495
NC,2020,2,6,23.89132681,1726,18.9016661984,3559,20.5312128806,5285
NC,2020,2,7,7.553632453,1872,9.50235964199,1229,8.32595935247,3101
NC,2020,2,8,17.16951864,3490,24.9427133534,3984,21.3130037535,7474
NC,2020,2,9,21.31882109,3113,27.524484115,3305,24.5144764807,6418
NC,2020,2,10,14.19684412,3343,22.11435625,3200,18.0690799164,6543
NC,2020,2,11,11.47718451,3225,21.2401353297,3473,16.5394013205,6698
NC,2020,2,12,15.6875114,3283,24.11979482,2973,19.6947330445,6256
NC,2020,2,13,20.88954308,3764,24.3575782093,3708,22.6105647957,7472
NC,2020,2,14,19.57506943,3529,24.9462051419,3734,22.3364381135,7263
NC,2020,2,15,18.54656145,3327,22.0007106599,3349,20.2793274332,6676
NC,2020,2,16,23.64296933,3324,26.8623729845,3287,25.2436620864,6611
NC,2020,2,17,16.50776709,3520,26.1032099804,3567,21.3373063577,7087
NC,2020,2,18,15.98863449,3896,23.5335177305,3525,19.5724794466,7421
NC,2020,2,19,14.78111996,4152,22.4086045389,4142,18.5902640552,8294
NC,2020,2,20,18.8975704,3836,21.9769605911,4060,20.4809447891,7896
NC,2020,2,21,19.5576746,3522,27.0489943343,3530,23.3075836559,7052
NC,2020,2,22,17.24638293,3384,25.7875178842,4613,22.1732624528,7997
NC,2020,2,23,22.46826024,3374,25.3528335745,3455,23.9276541294,6829
NC,2020,2,24,17.33936777,3733,24.1433448474,3474,20.6190980832,7207
NC,2020,2,25,17.0839866,3888,25.3736867779,3895,21.232564551,7783
NC,2020,2,26,18.78291275,3749,25.411990172,3663,22.0589935105,7412
NC,2020,2,27,22.00090643,3751,25.5993477673,3695,23.7865954901,7446
NC,2020,2,28,23.26029543,3588,26.5779637527,3752,24.9561934609,7340
NC,2020,2,29,24.41366843,3372,24.7049593724,3569,24.5634476222,6941
NC,2020,3,1,27.87803069,3321,35.0343249847,3274,31.4306777743,6595
NC,2020,3,2,19.79995442,3732,25.9155744199,3534,22.7744384662,7266
NC,2020,3,3,18.62301025,3714,28.0563348416,3757,23.366819712,7471
NC,2020,3,4,17.40211319,3639,30.006109101,3593,23.6640265346,7232
NC,2020,3,5,20.58108491,3650,25.9906744057,3618,23.2739708202,7268
NC,2020,3,6,22.84680049,3438,29.0831550069,3645,26.0561061816,7083
NC,2020,3,7,24.44975591,3236,27.4945479123,3329,25.9937182216,6565
NC,2020,3,8,27.72153721,3194,32.1096125,3200,29.9176336955,6394
NC,2020,3,9,18.56671714,3369,25.1721096654,3228,21.7988237145,6597
NC,2020,3,10,15.77617132,3795,23.2247876557,3532,19.3667968008,7327
NC,2020,3,11,17.44354075,4242,25.5957606541,4036,21.4182157359,8278
NC,2020,3,12,18.88729042,4211,24.3791626298,4335,21.6730692673,8546
NC,2020,3,13,19.83877781,3649,27.1052397779,3962,23.6214242844,7611
NC,2020,3,14,15.83813031,3530,22.2993158954,3479,19.0452161499,7009
NC,2020,3,15,18.8918317,3636,24.4577222063,3499,21.621341284,7135
NC,2020,3,16,11.36058715,4173,20.1747225131,3820,15.573022667,7993
NC,2020,3,17,7.887575918,4348,18.1086867336,4485,13.0773961385,8833
NC,2020,3,18,10.3261102,4211,16.2976355163,4077,13.2635991858,8288
NC,2020,3,19,9.12573825,4348,17.9368121212,4125,13.4153263202,8473
NC,2020,3,20,10.21017742,4002,20.0304991681,4207,15.2429577336,8209
NC,2020,3,21,9.134975717,3700,17.808509399,3777,13.5164036583,7477
NC,2020,3,22,7.51144354,3533,13.7611407367,3638,10.682047138,7171
NC,2020,3,23,5.787805846,3956,14.1203189246,3794,9.8669741841,7750
NC,2020,3,24,10.18311295,4099,13.2041807624,3961,11.6677841169,8060
NC,2020,3,25,13.01316976,4240,18.4354596384,3927,15.6204101607,8167
NC,2020,3,26,14.2456318,4590,23.3571435294,4250,18.6261662853,8840
NC,2020,3,27,12.95835151,4398,23.8476324614,4473,18.4490237787,8871
NC,2020,3,28,13.04556192,4200,28.8779830918,4140,20.9048213506,8340
NC,2020,3,29,9.735468786,3893,23.1813793964,4009,16.557115918,7902
NC,2020,3,30,6.942491896,4025,19.3213321168,3836,12.9831013715,7861
NC,2020,3,31,8.758256558,4233,16.1776244228,3898,12.3151002349,8131
NC,2020,4,1,9.775826169,4279,16.2810883699,4153,12.9798529622,8432
NC,2020,4,2,11.92095954,4398,20.1807682651,3983,15.8463644024,8381
NC,2020,4,3,13.51912397,4315,25.4724674419,4300,19.485389429,8615
NC,2020,4,4,10.21298944,4081,24.5642620555,4106,17.4105374258,8187
NC,2020,4,5,11.12406443,3725,21.4124896266,3856,16.3571692391,7581
NC,2020,4,6,9.507477241,3956,17.7669482289,3670,13.4823341156,7626
NC,2020,4,7,9.81286762,4223,18.2768213457,3879,13.8651604492,8102
NC,2020,4,8,9.602155866,3734,19.7629231518,4112,14.9272992612,7846
NC,2020,4,9,10.46037635,3215,21.6213648689,3319,16.1296939035,6534
NC,2020,4,10,5.567013789,3265,16.1893139293,3367,10.9598492191,6632
NC,2020,4,11,5.270406877,3195,14.3598682194,3263,9.86299163394,6458
NC,2020,4,12,5.518466661,3300,11.8481724782,3212,8.64055128705,6512
NC,2020,4,13,5.427889141,3482,11.4099650655,3435,8.3986034392,6917
NC,2020,4,14,4.513091013,3494,14.7675258036,3391,9.56360493819,6885
NC,2020,4,15,4.378641903,3446,12.5351326676,3505,8.49150338048,6951
NC,2020,4,16,5.430320937,3365,12.5861853513,3345,8.99758866662,6710
NC,2020,4,17,6.421847075,3178,17.7615859816,3367,12.2554453788,6545
NC,2020,4,18,5.872849854,3137,12.5215123653,3154,9.20616436051,6291
NC,2020,4,19,4.944721537,3196,12.5806218434,3168,8.74587366943,6364
NC,2020,4,20,4.224053379,3259,12.0353291339,3175,8.0787006469,6434
NC,2020,4,21,4.529411053,3294,12.1221580451,3151,8.24155159171,6445
NC,2020,4,22,5.756809525,3570,13.5927163391,3409,9.58437885145,6979
NC,2020,4,23,6.647741667,3600,14.4740110497,3620,10.5717160666,7220
NC,2020,4,24,5.960881816,3232,14.6374207493,3470,10.4532109862,6702
NC,2020,4,25,6.103854176,2976,14.7321994038,3019,10.4489708136,5995
NC,2020,4,26,5.491416125,2874,13.9187138047,2970,9.77428301561,5844
NC,2020,4,27,5.651558,3068,11.8493693086,2965,8.69755676181,6033
NC,2020,4,28,5.690404343,3141,15.3912013201,3030,10.4535569667,6171
NC,2020,4,29,6.08032542,3165,13.7081026786,3136,9.87666084023,6301
NC,2020,4,30,9.150240606,3283,17.5852460025,3252,13.347736788,6535
NC,2020,5,1,8.486030001,3000,15.3477673875,3422,12.1423466215,6422
NC,2020,5,2,8.743160334,2813,15.5846755524,2851,12.1868679413,5664
NC,2020,5,3,7.98239376,2778,15.4194101124,2848,11.7471684794,5626
NC,2020,5,4,8.004812085,3140,12.9478130217,2995,10.4178989319,6135
NC,2020,5,5,7.90678716,3181,14.7315541401,3140,11.2970368543,6321
NC,2020,5,6,7.739172908,3204,13.8733528837,3069,10.7402566551,6273
NC,2020,5,7,8.013689129,3204,15.0416258854,3106,11.473082404,6310
NC,2020,5,8,10.55317501,2948,18.8084469697,3168,14.8292871042,6116
NC,2020,5,9,11.18901009,2778,20.5155313925,2851,15.9127464967,5629
NC,2020,5,10,10.52942719,2706,18.9287395568,2753,14.7652408822,5459
NC,2020,5,11,8.151102324,2903,17.3309738104,2711,12.5840612837,5614
NC,2020,5,12,8.124322377,3003,17.2101012146,2964,12.6375197081,5967
NC,2020,5,13,8.033288343,2816,15.1058721934,2895,11.6184976316,5711
NC,2020,5,14,10.02985874,2831,14.3312603774,2650,12.1095365979,5481
NC,2020,5,15,9.66503016,2821,18.1240877368,3009,14.030948556,5830
NC,2020,5,16,11.04976406,2712,21.4343591549,2840,16.3617687555,5552
NC,2020,5,17,10.2257548,2716,16.2179673063,2814,13.274956607,5530
NC,2020,5,18,7.649034656,2942,18.809158045,2803,13.0940870249,5745
NC,2020,5,19,8.350751358,3061,17.3406908229,2953,12.7649999845,6014
NC,2020,5,20,8.641486391,3162,16.1829361022,3130,12.3930340064,6292
NC,2020,5,21,11.88553493,3122,15.3757124226,3067,13.6151155359,6189
NC,2020,5,22,13.66421162,2816,17.1181966167,3133,15.483229101,5949
NC,2020,5,23,10.20698674,2635,25.0084808743,2745,17.759050197,5380
NC,2020,5,24,10.56189496,2723,20.7021771879,2788,15.691836323,5511
NC,2020,5,25,11.17193558,2857,20.1511652542,2832,15.6418210498,5689
NC,2020,5,26,9.423802398,2935,24.2048170732,2952,16.8356514418,5887
NC,2020,5,27,8.140255818,2971,18.1531061599,3052,13.2140096356,6023
NC,2020,5,28,10.07808785,3096,16.3771792328,3024,13.1905800627,6120
NC,2020,5,29,11.21486697,3006,18.6060608914,3186,15.0178940749,6192
NC,2020,5,30,10.74781652,2954,16.1625863739,3097,13.519183606,6051
NC,2020,5,31,14.14079371,3011,18.893563981,3165,16.576434563,6176
NC,2020,6,1,11.53047971,3127,23.8499936447,3147,17.7098724981,6274
NC,2020,6,2,7.850140148,3068,15.2817959815,3235,11.6644201133,6303
NC,2020,6,3,8.455737396,2970,16.0635316456,3160,12.3775367155,6130
NC,2020,6,4,11.89944751,2932,16.1416729388,2923,14.0172997608,5855
NC,2020,6,5,14.21335631,2604,18.1085379123,2941,16.2793128641,5545
NC,2020,6,6,12.31819444,2448,22.1452934451,2624,17.4022456603,5072
NC,2020,6,7,11.86482308,2430,20.6762428408,2619,16.4354525816,5049
NC,2020,6,8,10.34716138,2702,19.4207826424,2581,14.7800624737,5283
NC,2020,6,9,10.37582547,2865,16.6566445066,2858,13.5123938444,5723
NC,2020,6,10,10.74456957,2904,14.5388008062,2977,12.6652338091,5881
NC,2020,6,11,12.92081637,2805,17.0474749164,2990,15.0500155165,5795
NC,2020,6,12,13.55232778,2642,22.3086636107,2836,18.0855458187,5478
NC,2020,6,13,13.98414235,2600,23.0631401515,2640,18.5582939141,5240
NC,2020,6,14,15.57126866,2609,20.9342802742,2626,18.2614823178,5235
NC,2020,6,15,12.58128323,2782,21.6870324006,2716,17.079503446,5498
NC,2020,6,16,9.052926488,2884,14.8632318166,2791,11.9104704831,5675
NC,2020,6,17,11.43174398,2953,16.3076840696,2988,13.8840767502,5941
NC,2020,6,18,15.41340503,3019,20.0232342007,2959,17.695185645,5978
NC,2020,6,19,15.79602223,2783,26.5769074262,2949,21.3425732495,5732
NC,2020,6,20,15.95962949,2726,22.879198947,2659,19.3763676861,5385
NC,2020,6,21,15.12875602,2693,24.289230486,2716,19.7284692109,5409
NC,2020,6,22,10.98180116,2826,21.0958610914,2822,16.0352496597,5648
NC,2020,6,23,12.13239463,2965,21.5317045069,2951,16.8209280051,5916
NC,2020,6,24,9.932251051,2852,22.2589893067,2899,16.1459902621,5751
NC,2020,6,25,13.00748768,2846,20.9299789104,2845,16.9680372408,5691
NC,2020,6,26,16.24105986,2755,20.9682776438,2903,18.6664952128,5658
NC,2020,6,27,14.98086499,2763,27.0158084264,2777,21.0135433154,5540
NC,2020,6,28,15.77278339,2770,23.7639366827,2906,19.8640961928,5676
NC,2020,6,29,11.83687029,2914,19.2030725863,2838,15.4713073757,5752
NC,2020,6,30,9.935705993,2762,19.3921396934,2935,14.8075039411,5697
NC,2020,7,1,12.83734733,2899,22.1843444026,2921,17.528512012,5820
NC,2020,7,2,14.62043882,2803,20.4841590525,2955,17.6296943405,5758
NC,2020,7,3,15.07299229,2707,24.7580316661,2779,19.9790667388,5486
NC,2020,7,4,15.30665119,2583,26.1939189687,2715,20.8859135568,5298
NC,2020,7,5,17.18043977,2547,24.1113669065,2502,20.6150168537,5049
NC,2020,7,6,14.29089492,2827,19.8535812274,2770,17.0439127995,5597
NC,2020,7,7,11.98635381,2962,19.5943526942,2858,15.7223780043,5820
NC,2020,7,8,12.66184721,2945,19.625607445,2955,16.1496288192,5900
NC,2020,7,9,10.74550601,2984,22.5528566588,2951,16.616355507,5935
NC,2020,7,10,14.25158748,2778,22.5418861681,3022,18.5711189689,5800
NC,2020,7,11,13.08711135,2676,23.1671553611,2742,18.1885289724,5418
NC,2020,7,12,15.90398077,2708,23.3455195531,2685,19.60888187,5393
NC,2020,7,13,11.61310256,2946,22.1435351768,2857,16.7975668002,5803
NC,2020,7,14,11.52497479,2983,19.0034785568,2938,15.2358081065,5921
NC,2020,7,15,10.77520641,3004,22.1884707846,2995,16.4732772221,5999
NC,2020,7,16,12.5782126,3010,22.8630693406,2942,17.6618901085,5952
NC,2020,7,17,14.67198916,2775,22.9135538306,2963,18.9277849284,5738
NC,2020,7,18,15.29583713,2616,24.4112936803,2690,19.9171296517,5306
NC,2020,7,19,15.43668315,2632,23.9636457933,2603,19.6765463325,5235
NC,2020,7,20,11.55498947,2850,19.0535734463,2832,15.2924040812,5682
NC,2020,7,21,9.865718584,3006,20.1398827182,2899,14.9097155061,5905
NC,2020,7,22,11.15450926,3016,21.1785452661,2894,16.0630642856,5910
NC,2020,7,23,13.54745233,2991,21.0317478604,3038,17.3187725857,6029
NC,2020,7,24,15.27837857,2689,21.0138168199,2937,18.2725097715,5626
NC,2020,7,25,15.43379069,2485,21.8994732795,2601,18.7403656832,5086
NC,2020,7,26,14.59474013,2540,20.522095387,2558,17.5688819008,5098
NC,2020,7,27,9.30776659,2776,20.7025549659,2638,14.8599372098,5414
NC,2020,7,28,11.45762224,2843,21.5334888808,2743,16.405366994,5586
NC,2020,7,29,10.92444251,2879,19.444720084,2858,15.1689872732,5737
NC,2020,7,30,13.31997601,2917,21.1778514405,2881,17.2245188032,5798
NC,2020,7,31,15.40815549,2624,21.3546750966,2847,18.5026064715,5471
ND,2020,1,1,42.76364962,137,19.6013095238,168,30.0053770424,305
ND,2020,1,2,45.77209344,129,41.9069291339,127,43.854609585,256
ND,2020,1,3,26.42383003,141,36.1629299363,157,31.5548323296,298
ND,2020,1,4,26.14644975,169,46.1671111111,135,35.0372039729,304
ND,2020,1,5,23.32305404,167,28.6445408163,196,26.1963637044,363
ND,2020,1,6,25.63834505,145,40.3005035971,139,32.8145423671,284
ND,2020,1,7,33.43775038,160,21.3689542484,153,27.5383069035,313
ND,2020,1,8,48.31655617,151,57.5697142857,140,52.7682473597,291
ND,2020,1,9,40.21687496,160,22.9431428571,140,32.1557999787,300
ND,2020,1,10,41.12638412,177,40.4721710526,152,40.8241337059,329
ND,2020,1,11,74.79442552,174,27.8494021739,184,50.6662570963,358
ND,2020,1,12,32.03109065,165,30.1005517241,145,31.1280966363,310
ND,2020,1,13,26.0441668,168,26.0875,156,26.0650309333,324
ND,2020,1,14,15.37235804,123,22.544491018,167,19.5025173756,290
ND,2020,1,15,35.65767988,125,27.7421428571,84,32.4763157177,209
ND,2020,1,16,13.0274844,159,27.836122449,147,20.1414379725,306
ND,2020,1,17,15.12514816,169,30.7756790123,162,22.7849245892,331
ND,2020,1,18,39.20433114,157,6.00818791946,149,23.0401960424,306
ND,2020,1,19,23.29060968,164,36.5000568182,176,30.1284411398,340
ND,2020,1,20,33.21690278,155,35.032585034,147,34.1006951354,302
ND,2020,1,21,11.17865416,156,26.0142405063,158,18.6436944234,314
ND,2020,1,22,26.87287513,160,17.6243661972,142,22.5242384795,302
ND,2020,1,23,16.02387475,160,25.6680346821,173,21.0342040841,333
ND,2020,1,24,26.57316803,161,44.5234246575,146,35.1097721591,307
ND,2020,1,25,15.29346145,156,43.8082312925,147,29.1273596904,303
ND,2020,1,26,18.48762189,164,22.2560540541,185,20.4852148709,349
ND,2020,1,27,6.072551793,145,29.1010869565,138,17.3020141696,283
ND,2020,1,28,8.939074148,162,14.6550331126,151,11.6966134568,313
ND,2020,1,29,28.51682157,151,12.8908125,160,20.4777172253,311
ND,2020,1,30,6.6118667,150,17.1919858156,141,11.7383161684,291
ND,2020,1,31,14.2808917,157,39.7921301775,169,27.5060429353,326
ND,2020,2,1,23.72685364,178,28.3358490566,159,25.9014241778,337
ND,2020,2,2,2.456310693,103,17.0066492147,191,11.9090816373,294
ND,2020,2,3,8.426296198,81,6.1968115942,69,7.40073328025,150
ND,2020,2,4,24.97557189,131,30.2124770642,109,27.3539996566,240
ND,2020,2,5,23.40956541,161,43.368404908,163,33.4505865155,324
ND,2020,2,6,26.13147102,68,26.0103007519,133,26.0512936784,201
ND,2020,2,7,10.18766199,77,32.0659183673,49,18.6958728034,126
ND,2020,2,8,15.14759401,133,36.8770068027,147,26.5555357262,280
ND,2020,2,9,29.20816001,125,28.2170422535,142,28.6810486938,267
ND,2020,2,10,15.92620172,129,51.4489705882,136,34.1567547995,265
ND,2020,2,11,8.092999928,140,22.5902758621,145,15.4688069822,285
ND,2020,2,12,4.585454704,143,39.2800813008,123,20.6284587318,266
ND,2020,2,13,23.03701785,171,46.1715131579,152,33.9238391714,323
ND,2020,2,14,16.50773228,172,23.8862941176,170,20.1754384566,342
ND,2020,2,15,28.84089423,123,29.468943662,142,29.1774339256,265
ND,2020,2,16,39.31369344,111,26.93456,125,32.7569490332,236
ND,2020,2,17,39.77052219,134,27.3099186992,123,33.8068870563,257
ND,2020,2,18,12.34123078,130,39.8320720721,111,25.0029875577,241
ND,2020,2,19,10.07771246,153,17.4978231293,147,13.7135666879,300
ND,2020,2,20,53.55849945,160,28.5131506849,146,41.6087578824,306
ND,2020,2,21,15.59976905,173,32.5683333333,174,24.1085015725,347
ND,2020,2,22,30.66664337,143,45.8760638298,188,39.3052265919,331
ND,2020,2,23,21.73732314,127,27.961294964,139,24.9896993939,266
ND,2020,2,24,29.29128842,132,28.496875,128,28.9001925825,260
ND,2020,2,25,20.55757572,165,23.1622794118,136,21.7344518066,301
ND,2020,2,26,33.3578145,151,22.4746853147,143,28.0643196922,294
ND,2020,2,27,22.6652173,161,15.0867910448,134,19.2228135095,295
ND,2020,2,28,22.7051766,170,30.8849350649,154,26.5930864877,324
ND,2020,2,29,40.83972469,145,28.4944099379,161,34.3443139871,306
ND,2020,3,1,30.35650363,123,55.1518548387,124,42.804372253,247
ND,2020,3,2,28.01586188,145,34.5913868613,137,31.2103545128,282
ND,2020,3,3,16.60705495,146,32.5928,150,24.7079392659,296
ND,2020,3,4,24.34801495,136,42.1630656934,137,33.2881686198,273
ND,2020,3,5,15.21683872,155,30.0339041096,146,22.4038538259,301
ND,2020,3,6,30.08405829,138,28.9859310345,145,29.5214135831,283
ND,2020,3,7,12.92971626,141,32.4998675497,151,23.0498972351,292
ND,2020,3,8,11.42193544,124,39.6004918033,122,25.3966666446,246
ND,2020,3,9,46.57854576,165,36.0597826087,138,41.7878219485,303
ND,2020,3,10,24.49500005,172,34.1919745223,157,29.1224316371,329
ND,2020,3,11,20.09666661,201,12.0889940828,169,16.4391080773,370
ND,2020,3,12,15.24560388,207,35.8691625616,203,25.4567804955,410
ND,2020,3,13,9.913235276,170,18.8738709677,186,14.5949157217,356
ND,2020,3,14,4.65244287,131,33.9209027778,144,19.9784727853,275
ND,2020,3,15,14.56694414,144,30.4412962963,162,22.9710129286,306
ND,2020,3,16,6.759537591,173,46.9242384106,151,25.4782716149,324
ND,2020,3,17,2.205801163,181,25.8170481928,166,13.5010951311,347
ND,2020,3,18,10.2366469,170,17.4050574713,174,13.8625289913,344
ND,2020,3,19,8.139402149,184,17.2496449704,169,12.5009631598,353
ND,2020,3,20,9.118136849,161,9.48693877551,196,9.32061633806,357
ND,2020,3,21,8.701145166,131,28.9071621622,148,19.419749164,279
ND,2020,3,22,31.7603906,128,27.3865625,128,29.57347655,256
ND,2020,3,23,3.642052936,151,15.1220689655,145,9.26570943695,296
ND,2020,3,24,10.94554346,184,11.5878787879,165,11.2492263514,349
ND,2020,3,25,18.90738102,168,16.5826627219,169,17.741572734,337
ND,2020,3,26,12.90425293,174,11.5104848485,165,12.2258702355,339
ND,2020,3,27,11.2894629,149,29.8788343558,163,21.0012178593,312
ND,2020,3,28,11.60823904,159,39.3002877698,139,24.5250000247,298
ND,2020,3,29,10.91230765,156,23.2471875,128,16.4716901176,284
ND,2020,3,30,13.73445788,166,11.168125,176,12.4137719535,342
ND,2020,3,31,6.996318981,163,13.2067948718,156,10.0334169088,319
ND,2020,4,1,6.593442779,183,13.6861904762,168,9.98826218962,351
ND,2020,4,2,17.42465086,172,26.1189102564,156,21.559725451,328
ND,2020,4,3,1.959477589,134,16.4216,150,9.59792252439,284
ND,2020,4,4,5.035669254,127,29.8246376812,138,17.9446414915,265
ND,2020,4,5,4.018273526,139,4.33279069767,129,4.16966425416,268
ND,2020,4,6,6.69198826,171,9.95915384615,130,8.10305645336,301
ND,2020,4,7,5.713103587,174,29.0450314465,159,16.8535736461,333
ND,2020,4,8,10.44845629,149,12.3012179487,156,11.3960983187,305
ND,2020,4,9,15.76370622,143,18.0449557522,113,16.7706640213,256
ND,2020,4,10,20.65633792,142,13.5567938931,131,17.2495970133,273
ND,2020,4,11,0.236106875,131,12.2213333333,120,5.96609562002,251
ND,2020,4,12,2.140336085,119,9.96508333333,120,6.06907947328,239
ND,2020,4,13,5.979925594,134,7.16459016393,122,6.54449230311,256
ND,2020,4,14,5.208301972,159,27.4154744526,137,15.4866216674,296
ND,2020,4,15,25.5929284,140,19.6990977444,133,22.7215750037,273
ND,2020,4,16,1.990757541,132,23.5492753623,138,13.0095555386,270
ND,2020,4,17,13.15363675,132,21.7349180328,122,17.2753545315,254
ND,2020,4,18,4.265153903,130,12.9261111111,126,8.52796877887,256
ND,2020,4,19,1.868608655,115,24.0238461538,130,13.6244489605,245
ND,2020,4,20,12.74554701,128,35.1531404959,121,23.6343775794,249
ND,2020,4,21,11.17066213,136,34.1550434783,115,21.7013547796,251
ND,2020,4,22,8.167761043,134,22.7881451613,124,15.1946123247,258
ND,2020,4,23,8.620500072,160,28.3342361111,144,17.9585855642,304
ND,2020,4,24,12.20842971,121,25.2602083333,144,19.3007169619,265
ND,2020,4,25,17.26192639,109,14.4302564103,117,15.7959733474,226
ND,2020,4,26,18.971262,103,37.0372566372,113,28.4224536389,216
ND,2020,4,27,1.800869586,115,20.6351351351,111,11.0513274442,226
ND,2020,4,28,7.832892535,121,16.568968254,126,12.2893522135,247
ND,2020,4,29,5.746194539,113,30.6258878505,107,17.8467726496,220
ND,2020,4,30,22.53200026,115,12.2993636364,110,17.5293779107,225
ND,2020,5,1,8.480803733,112,11.2112621359,103,9.7888838051,215
ND,2020,5,2,7.510599755,100,15.997804878,82,11.3345053599,182
ND,2020,5,3,9.0558255,103,45.0229824561,114,27.951013947,217
ND,2020,5,4,2.827226968,119,15.2616814159,113,8.88366383272,232
ND,2020,5,5,16.02076869,117,15.0452991453,117,15.5330339176,234
ND,2020,5,6,11.38648441,128,22.8284545455,110,16.6747899348,238
ND,2020,5,7,12.21440001,125,12.2010091743,109,12.2081623985,234
ND,2020,5,8,14.40289216,121,43.7229090909,110,28.3648049842,231
ND,2020,5,9,13.85948969,98,14.9272727273,110,14.4241826424,208
ND,2020,5,10,19.44728146,103,28.1633684211,95,23.6292423757,198
ND,2020,5,11,11.4098075,104,22.6466666667,105,17.0551195215,209
ND,2020,5,12,0.32716667,120,8.45118181818,110,4.21256521913,230
ND,2020,5,13,3.730178563,112,26.2970535714,112,15.0136160672,224
ND,2020,5,14,6.983131212,99,25.9252222222,90,16.0031745502,189
ND,2020,5,15,7.253434586,99,33.3671698113,106,20.7561464586,205
ND,2020,5,16,2.320721681,97,11.7486538462,104,7.1988557366,201
ND,2020,5,17,15.62152188,92,23.6075,100,19.7808854842,192
ND,2020,5,18,3.74319986,100,21.6569072165,97,12.5636547513,197
ND,2020,5,19,13.66431181,109,6.34365384615,104,10.0899060436,213
ND,2020,5,20,7.973606597,122,11.6077586207,116,9.74487396989,238
ND,2020,5,21,27.30903977,125,20.2944859813,107,24.0738791864,232
ND,2020,5,22,25.80991133,113,19.9158823529,102,23.0136743269,215
ND,2020,5,23,22.5789217,102,31.000733945,109,26.9295261299,211
ND,2020,5,24,10.57954052,87,37.3976363636,110,25.5541118032,197
ND,2020,5,25,9.016333407,90,9.39243902439,82,9.19563957343,172
ND,2020,5,26,3.510673117,104,32.5976041667,96,17.4724000208,200
ND,2020,5,27,21.49571447,105,35.6029,100,28.3772683871,205
ND,2020,5,28,41.64591371,115,10.8391964286,112,26.4461236857,227
ND,2020,5,29,4.998294636,129,17.9672307692,130,11.5077992589,259
ND,2020,5,30,18.37704364,115,21.5779831933,119,20.0048718744,234
ND,2020,5,31,26.27800011,115,24.1351612903,124,25.1662343626,239
ND,2020,6,1,2.155187937,133,14.75,125,8.25732556442,258
ND,2020,6,2,2.398699232,123,22.5580952381,126,12.5998393797,249
ND,2020,6,3,20.50208349,120,19.5385833333,120,20.0203334117,240
ND,2020,6,4,16.96605275,114,15.7581730769,104,16.3898165757,218
ND,2020,6,5,9.273636379,88,10.7751327434,113,10.1177612008,201
ND,2020,6,6,26.25456526,92,29.8808974359,78,27.9184117878,170
ND,2020,6,7,13.14930688,101,41.5534951456,103,27.4906372298,204
ND,2020,6,8,12.9612383,105,36.6274747475,99,24.4463236348,204
ND,2020,6,9,6.681415191,106,18.2096629213,89,11.9430256936,195
ND,2020,6,10,19.69629311,116,37.4329126214,103,28.0381735195,219
ND,2020,6,11,5.456288739,97,39.87325,120,24.4887097128,217
ND,2020,6,12,20.56065823,76,30.6565168539,89,26.0063031847,165
ND,2020,6,13,59.9437982,79,38.9357831325,83,49.1804324556,162
ND,2020,6,14,10.80127898,86,51.205125,80,30.2730120017,166
ND,2020,6,15,2.925999996,90,19.2298181818,110,11.8930999982,200
ND,2020,6,16,19.86890875,110,9.55947368421,95,15.0913656707,205
ND,2020,6,17,22.66352903,119,16.2181188119,101,19.7044997935,220
ND,2020,6,18,11.11400015,90,19.1380392157,102,15.3767709036,192
ND,2020,6,19,25.16465171,86,35.9404819277,83,30.4569233554,169
ND,2020,6,20,19.39416674,84,29.2295555556,90,24.481436817,174
ND,2020,6,21,33.49337239,86,40.66,89,37.1381144317,175
ND,2020,6,22,24.15752709,93,34.3482608696,92,29.2253514561,185
ND,2020,6,23,45.33858508,99,33.2339805825,103,39.166435262,202
ND,2020,6,24,23.10422291,90,20.3493478261,92,21.7116486918,182
ND,2020,6,25,25.34780018,100,45.4624761905,105,35.6504391122,205
ND,2020,6,26,19.50950517,101,9.183,100,14.3719404088,201
ND,2020,6,27,16.55514824,101,35.8874509804,102,26.2689161194,203
ND,2020,6,28,12.77098768,81,39.9571875,96,27.5160452095,177
ND,2020,6,29,13.70459197,98,34.3899009901,101,24.2031658948,199
ND,2020,6,30,11.06280697,114,29.7214018692,107,20.0966063103,221
ND,2020,7,1,17.23346158,130,35.3440495868,121,25.9640637665,251
ND,2020,7,2,14.63981975,111,39.9926229508,122,27.9146780783,233
ND,2020,7,3,11.84125,104,23.5145744681,94,17.3831313131,198
ND,2020,7,4,5.318823565,85,24.3582242991,107,15.9293229324,192
ND,2020,7,5,19.75817342,104,37.7341052632,95,28.3396484205,199
ND,2020,7,6,7.274206317,126,18.211372549,102,12.167149105,228
ND,2020,7,7,7.088628985,124,31.1300869565,115,18.6566945362,239
ND,2020,7,8,16.7745525,134,40.28904,125,28.1232433784,259
ND,2020,7,9,11.87974577,118,17.7043801653,121,14.8286192505,239
ND,2020,7,10,14.84043853,114,29.6012605042,119,22.3792274353,233
ND,2020,7,11,8.708715547,109,27.4585294118,102,17.7726066096,211
ND,2020,7,12,10.91072149,97,26.4074311927,109,19.1104368181,206
ND,2020,7,13,9.194351308,131,21.5142990654,107,14.7331513502,238
ND,2020,7,14,5.053826066,115,25.1883486239,109,14.8514285607,224
ND,2020,7,15,13.05362201,127,27.6748598131,107,19.7394016892,234
ND,2020,7,16,34.51692872,127,27.0712820513,117,30.9466801125,244
ND,2020,7,17,33.16850955,114,35.1428181818,110,34.1380361103,224
ND,2020,7,18,32.99478787,94,26.7908490566,106,29.7067002989,200
ND,2020,7,19,31.55462313,106,41.8788,100,36.5663594747,206
ND,2020,7,20,1.567350422,117,27.6057894737,114,14.4174891748,231
ND,2020,7,21,26.71299241,137,21.9196153846,104,24.6444811625,241
ND,2020,7,22,24.00561002,123,24.8267272727,110,24.3932619419,233
ND,2020,7,23,40.19104758,124,18.1727419355,124,29.1818947577,248
ND,2020,7,24,28.97199999,130,28.8561481481,135,28.9129811272,265
ND,2020,7,25,11.17019047,105,36.2283333333,114,24.2141552482,219
ND,2020,7,26,29.40747273,91,43.0892708333,96,36.431283521,187
ND,2020,7,27,12.02841667,120,15.715631068,103,13.7314798224,223
ND,2020,7,28,8.036134349,119,46.0097457627,118,26.9428269516,237
ND,2020,7,29,23.84811012,127,19.2351401869,107,21.7387606207,234
ND,2020,7,30,24.42711996,125,41.379609375,128,33.003873498,253
ND,2020,7,31,17.79801714,116,36.2181679389,131,27.5674088593,247
NE,2020,1,1,24.03340909,572,32.80694974,577,28.4392689291,1149
NE,2020,1,2,16.56871206,528,24.2638589212,482,20.241049473,1010
NE,2020,1,3,14.84758446,563,26.1469589552,536,20.358471384,1099
NE,2020,1,4,15.58298955,572,25.1464673913,552,20.2796441482,1124
NE,2020,1,5,19.48700006,530,20.0958674464,513,19.7864717467,1043
NE,2020,1,6,19.89531915,564,17.7505532787,488,18.9004087458,1052
NE,2020,1,7,13.69471413,577,17.5470017331,577,15.6208579316,1154
NE,2020,1,8,12.48696531,547,26.2757647059,510,19.1400284055,1057
NE,2020,1,9,12.40244899,588,22.4371819961,511,17.0682802603,1099
NE,2020,1,10,18.67747705,547,21.0072027972,572,19.8683645633,1119
NE,2020,1,11,13.71698707,541,23.5032111693,573,18.7506553006,1114
NE,2020,1,12,19.12766496,591,23.3997969543,591,21.2637309572,1182
NE,2020,1,13,17.33546964,596,21.4671333333,600,19.4082106233,1196
NE,2020,1,14,5.930538024,446,23.9084775087,578,16.0782421472,1024
NE,2020,1,15,15.64182658,438,19.1932024169,331,17.1704421873,769
NE,2020,1,16,12.96674656,624,24.3192832168,572,18.3962206132,1196
NE,2020,1,17,17.42623115,597,17.4530940989,627,17.4399918272,1224
NE,2020,1,18,13.62380192,626,28.7899122807,570,20.8517976605,1196
NE,2020,1,19,12.42387506,560,20.7831587302,630,16.8493781795,1190
NE,2020,1,20,13.83442751,594,27.1615955473,539,20.1745365763,1133
NE,2020,1,21,12.16702734,619,27.5836287625,598,19.7423171105,1217
NE,2020,1,22,12.63718295,639,20.610912,625,16.5798891654,1264
NE,2020,1,23,16.82706797,573,25.2988927336,578,21.0813813613,1151
NE,2020,1,24,16.69453398,558,25.651393597,531,21.0619283387,1089
NE,2020,1,25,14.43447018,604,17.9730931459,569,16.1509889077,1173
NE,2020,1,26,17.83394465,578,23.3821765601,657,20.7855141763,1235
NE,2020,1,27,9.123083915,548,25.0746138614,505,16.7731528826,1053
NE,2020,1,28,12.8203296,607,22.0172998138,537,17.1374388699,1144
NE,2020,1,29,19.20200651,603,25.0323426573,572,22.0402637664,1175
NE,2020,1,30,22.38701709,647,22.683466899,574,22.5263800633,1221
NE,2020,1,31,22.61573477,626,34.0147020934,621,28.2923656504,1247
NE,2020,2,1,21.20001438,689,28.1654833333,600,24.4422807663,1289
NE,2020,2,2,17.52725004,400,15.06336,750,15.9203652313,1150
NE,2020,2,3,16.4125526,333,28.3215936255,251,21.5309931777,584
NE,2020,2,4,8.644909053,550,23.221564482,473,15.384652961,1023
NE,2020,2,5,10.346276,580,26.6187371512,681,19.1341792863,1261
NE,2020,2,6,10.0312122,264,17.8716875,480,15.0895833613,744
NE,2020,2,7,13.3591222,319,15.9333469388,245,14.4773581238,564
NE,2020,2,8,14.50705979,585,28.6748447205,644,21.9310252052,1229
NE,2020,2,9,16.43990387,520,17.6976503759,532,17.0759505821,1052
NE,2020,2,10,12.71998049,513,15.1009259259,486,13.8782782696,999
NE,2020,2,11,11.00163816,525,20.4080039139,511,15.6412645116,1036
NE,2020,2,12,17.48897879,568,18.7831105991,434,18.0495109309,1002
NE,2020,2,13,13.31449229,650,17.7688851913,601,15.4544524289,1251
NE,2020,2,14,21.58603211,620,36.2167623604,627,28.942461835,1247
NE,2020,2,15,10.89938365,503,30.0146826758,583,21.1610957421,1086
NE,2020,2,16,23.61498075,520,28.1433669355,496,25.8256889665,1016
NE,2020,2,17,19.89971945,606,22.8952197802,546,21.319461794,1152
NE,2020,2,18,12.60296583,644,22.9325668449,561,17.412016593,1205
NE,2020,2,19,14.65146337,615,27.6293474427,567,20.8768950698,1182
NE,2020,2,20,21.7675432,635,24.5678036606,601,23.129158521,1236
NE,2020,2,21,27.31030539,589,33.4671794872,585,30.3782537263,1174
NE,2020,2,22,15.30213644,557,29.6641751269,788,23.7164758343,1345
NE,2020,2,23,20.22798,505,24.3822033898,531,22.3572199807,1036
NE,2020,2,24,14.49138323,600,27.7778404669,514,20.6217593698,1114
NE,2020,2,25,18.27947025,604,20.9884283247,579,19.60532547,1183
NE,2020,2,26,16.42326773,609,23.8468347826,575,20.028462878,1184
NE,2020,2,27,18.96838503,613,19.5957345133,565,19.2692784579,1178
NE,2020,2,28,23.16640327,595,29.161358885,574,26.1100341708,1169
NE,2020,2,29,17.77728088,559,24.0790721649,582,20.9916915091,1141
NE,2020,3,1,10.70169884,518,26.8054563895,493,18.5544708201,1011
NE,2020,3,2,14.52353847,585,23.7779087452,526,18.904995504,1111
NE,2020,3,3,16.57919937,612,18.1732358318,547,17.3315185629,1159
NE,2020,3,4,14.73015997,625,25.7676410256,585,20.0664627944,1210
NE,2020,3,5,16.02792416,607,28.7785017422,574,22.2250719434,1181
NE,2020,3,6,19.56107391,596,31.3386643836,584,25.3899830935,1180
NE,2020,3,7,21.30743782,562,28.8324831081,592,25.1677730111,1154
NE,2020,3,8,19.23505866,512,28.7881419624,479,23.8525429202,991
NE,2020,3,9,13.31942859,560,24.4549203187,502,18.5830979382,1062
NE,2020,3,10,17.92731774,686,20.6754513274,565,19.1684811908,1251
NE,2020,3,11,12.6350122,818,23.3453542234,734,17.7003414817,1552
NE,2020,3,12,14.28986214,798,19.0760838323,835,16.7371953385,1633
NE,2020,3,13,11.71534589,694,21.7473603352,716,16.8096170551,1410
NE,2020,3,14,14.13931716,659,18.2032018209,659,16.1712594905,1318
NE,2020,3,15,11.71870674,665,20.8652410575,643,16.2150535031,1308
NE,2020,3,16,9.887837524,763,14.923028169,710,12.3148472714,1473
NE,2020,3,17,9.843505876,773,18.3718435013,754,14.0546169235,1527
NE,2020,3,18,8.053090584,728,17.7119219653,692,12.7600703839,1420
NE,2020,3,19,7.744161254,769,12.2466712517,727,9.93221256974,1496
NE,2020,3,20,5.90889363,714,11.0153526971,723,8.47811416271,1437
NE,2020,3,21,7.448174861,652,10.4307012195,656,8.94399847811,1308
NE,2020,3,22,6.282895958,625,8.42169657423,613,7.34193051191,1238
NE,2020,3,23,5.642330353,678,13.3995611285,638,9.40305469554,1316
NE,2020,3,24,10.12425103,701,11.4345180723,664,10.7616263531,1365
NE,2020,3,25,8.205313781,749,9.84302496329,681,8.98523078459,1430
NE,2020,3,26,5.655280741,748,9.52682080925,692,7.51577082935,1440
NE,2020,3,27,6.313717748,659,9.46971711457,707,7.94716690771,1366
NE,2020,3,28,9.806806061,670,12.497379845,645,11.1265171566,1315
NE,2020,3,29,5.288645831,672,9.52360708535,621,7.32260634063,1293
NE,2020,3,30,5.443650561,704,12.638262987,616,8.80113635981,1320
NE,2020,3,31,5.048942841,700,12.3178888889,630,8.49212781105,1330
NE,2020,4,1,5.527493024,714,9.77664201183,676,7.59398562528,1390
NE,2020,4,2,2.906985924,710,10.1451470588,680,6.44795683888,1390
NE,2020,4,3,9.009999967,639,10.2616310976,656,9.64403087175,1295
NE,2020,4,4,3.938184853,595,11.3055160745,591,7.60942663367,1186
NE,2020,4,5,7.950163655,611,12.3977264957,585,10.125602001,1196
NE,2020,4,6,4.11278322,715,9.34582258065,620,6.54310861596,1335
NE,2020,4,7,4.615779399,680,14.6255214724,652,9.51544293643,1332
NE,2020,4,8,6.875039486,633,14.4944897959,637,10.6967637753,1270
NE,2020,4,9,4.385205484,584,8.65229508197,549,6.4528420147,1133
NE,2020,4,10,8.015699625,586,17.2813934426,610,12.7415133614,1196
NE,2020,4,11,5.511781326,567,16.1390334572,538,10.6859547618,1105
NE,2020,4,12,5.549035692,560,11.8585968028,563,8.7122439782,1123
NE,2020,4,13,3.354858584,601,10.5785037879,528,6.73314438351,1129
NE,2020,4,14,5.973106927,618,15.5544112769,603,10.7049058812,1221
NE,2020,4,15,6.240560695,660,10.820562701,622,8.46268335312,1282
NE,2020,4,16,4.190513123,682,11.2295321637,684,7.71517565877,1366
NE,2020,4,17,4.579105673,615,11.2570731707,656,8.02579857506,1271
NE,2020,4,18,3.868274033,562,12.7868347826,575,8.37854002335,1137
NE,2020,4,19,5.513327336,550,9.18033864542,502,7.26317493802,1052
NE,2020,4,20,6.175822364,608,12.6236580882,544,9.22063367822,1152
NE,2020,4,21,4.949317034,615,9.80971571906,598,7.34545752342,1213
NE,2020,4,22,4.260953046,661,11.9787775891,589,7.89759197072,1250
NE,2020,4,23,4.562615419,650,17.2025115562,649,10.8776982466,1299
NE,2020,4,24,3.02161001,559,15.3813322368,608,9.46095115303,1167
NE,2020,4,25,2.615511517,479,11.2386162362,542,7.19310481552,1021
NE,2020,4,26,5.806515099,462,14.5967252747,455,10.1680697663,917
NE,2020,4,27,5.429851633,539,12.2394129979,477,8.62686026593,1016
NE,2020,4,28,3.21644126,562,16.3464,500,9.39815441443,1062
NE,2020,4,29,4.709402511,569,10.7293235832,547,7.66002690749,1116
NE,2020,4,30,10.00796697,605,15.9022318339,578,12.8878360244,1183
NE,2020,5,1,7.303283064,530,17.9590138675,649,13.1689058727,1179
NE,2020,5,2,8.137552845,474,17.2106790123,486,12.7308229672,960
NE,2020,5,3,7.047795566,499,16.3641774892,462,11.5266389047,961
NE,2020,5,4,8.697462241,595,14.9002443609,532,11.6254836144,1127
NE,2020,5,5,5.84096393,581,14.6989849624,532,10.0749865618,1113
NE,2020,5,6,5.349665414,538,22.1331477927,521,13.6066949884,1059
NE,2020,5,7,6.301860055,543,12.6013009709,515,9.36822307171,1058
NE,2020,5,8,7.580300625,499,18.7768627451,561,13.5060283131,1060
NE,2020,5,9,6.231237799,509,13.8261643836,511,10.0361470977,1020
NE,2020,5,10,9.977337196,522,14.5672908367,502,12.2274902503,1024
NE,2020,5,11,10.66603599,555,13.0251405622,498,11.7817378675,1053
NE,2020,5,12,6.167921605,587,13.1030701754,570,9.58454622484,1157
NE,2020,5,13,5.449812439,533,13.9678228782,542,9.7444744465,1075
NE,2020,5,14,7.456867625,498,22.9425726141,482,15.0733062013,980
NE,2020,5,15,5.277699835,513,12.8070566728,547,9.16313208996,1060
NE,2020,5,16,7.94922925,506,11.7003180915,503,9.81919722547,1009
NE,2020,5,17,5.907189346,523,16.7450833333,480,11.0938185722,1003
NE,2020,5,18,2.991257026,533,15.1090962672,509,8.91062379545,1042
NE,2020,5,19,5.536461872,537,13.1986907021,527,9.33156957262,1064
NE,2020,5,20,4.755165445,544,14.4080478821,543,9.57716651525,1087
NE,2020,5,21,4.905304676,558,16.3713430127,551,10.6021370687,1109
NE,2020,5,22,10.51430554,504,18.2021787709,537,14.4800960539,1041
NE,2020,5,23,7.403675277,468,19.3168874172,453,13.2632682189,921
NE,2020,5,24,11.27050841,472,13.976964657,481,12.6365162324,953
NE,2020,5,25,11.22136713,512,16.8476263736,455,13.8686762881,967
NE,2020,5,26,6.023701541,516,11.7286938776,490,8.80247514429,1006
NE,2020,5,27,6.016660417,530,19.2261330561,481,12.3012858764,1011
NE,2020,5,28,10.05939348,544,14.9391601562,512,12.4253409594,1056
NE,2020,5,29,10.00301255,561,24.5163227017,533,17.073939708,1094
NE,2020,5,30,9.640400023,575,17.5463148479,559,13.5375837859,1134
NE,2020,5,31,9.746092934,581,15.370172117,581,12.5581325255,1162
NE,2020,6,1,14.01345693,593,24.7724345146,649,19.6354991622,1242
NE,2020,6,2,9.206708908,553,20.3781060606,528,14.6632285163,1081
NE,2020,6,3,8.476882339,510,19.4184716981,530,14.0528846085,1040
NE,2020,6,4,10.54850714,489,19.8948809524,504,15.2922859934,993
NE,2020,6,5,5.516152214,473,24.092892057,491,14.9779564287,964
NE,2020,6,6,9.139620038,421,15.7555319149,423,12.4554147346,844
NE,2020,6,7,12.54230555,399,19.4160987654,405,16.0048506399,804
NE,2020,6,8,8.562975919,457,22.1579097387,421,15.0817312016,878
NE,2020,6,9,6.197025968,501,15.7078181818,495,10.9237751104,996
NE,2020,6,10,9.220344765,493,22.5068907563,476,15.7470691116,969
NE,2020,6,11,8.315090431,497,20.9519583333,480,14.523582338,977
NE,2020,6,12,12.62137491,480,19.8123173278,479,16.213096931,959
NE,2020,6,13,17.53594086,441,29.3944600939,426,23.3626181306,867
NE,2020,6,14,17.11778285,433,25.4870689655,464,21.447045679,897
NE,2020,6,15,9.082950856,488,18.1866206897,435,13.3734128036,923
NE,2020,6,16,5.188981686,491,19.5085927505,469,12.1847083415,960
NE,2020,6,17,6.284510626,521,16.5439655172,464,11.1173908996,985
NE,2020,6,18,7.135764076,517,20.4683267717,508,13.7435122217,1025
NE,2020,6,19,10.90873416,474,17.6354786151,491,14.3313575045,965
NE,2020,6,20,10.80721411,481,24.6183119658,468,17.6181664772,949
NE,2020,6,21,12.98167711,477,21.1141350211,474,17.0350788449,951
NE,2020,6,22,10.91442994,465,19.1779229122,467,15.0550428349,932
NE,2020,6,23,6.199375061,496,19.6223706897,464,12.6871562815,960
NE,2020,6,24,12.79226473,499,24.1647454175,491,18.4325556568,990
NE,2020,6,25,12.15876533,486,23.329877551,490,17.7672130639,976
NE,2020,6,26,9.928634415,454,25.467593361,482,17.9305342141,936
NE,2020,6,27,14.54186534,445,25.791372549,408,19.9226378386,853
NE,2020,6,28,9.34525385,453,33.8210657596,441,21.4188926108,894
NE,2020,6,29,13.43134358,521,18.883526971,482,16.0514356981,1003
NE,2020,6,30,7.35988616,527,26.0107364341,516,16.5869606964,1043
NE,2020,7,1,11.10542649,551,23.706290631,523,17.241601486,1074
NE,2020,7,2,11.17257756,516,18.7654794521,511,14.9505452979,1027
NE,2020,7,3,18.92463104,488,23.5633401222,491,21.2510928984,979
NE,2020,7,4,10.60165117,430,23.9176551724,435,17.2981387319,865
NE,2020,7,5,18.75672768,437,19.5399280576,417,19.1391569042,854
NE,2020,7,6,13.0365298,487,19.4996666667,450,16.1404909419,937
NE,2020,7,7,7.319253445,509,14.5996624473,474,10.8298474095,983
NE,2020,7,8,14.39796564,526,23.1081060606,528,18.7612997406,1054
NE,2020,7,9,10.47539061,512,23.50192607,514,17.0013547683,1026
NE,2020,7,10,13.68925049,467,20.2154375,480,16.9971383092,947
NE,2020,7,11,10.9825273,459,20.4529398148,432,15.5742424587,891
NE,2020,7,12,19.30268379,462,26.5843224299,428,22.8044156303,890
NE,2020,7,13,11.16356612,530,21.9867080745,483,16.3240572987,1013
NE,2020,7,14,13.35809433,530,18.7931211499,487,15.9607079596,1017
NE,2020,7,15,11.31629277,526,15.3607386364,528,13.3423529383,1054
NE,2020,7,16,8.509244183,516,16.8198742138,477,12.501359515,993
NE,2020,7,17,13.68208079,495,27.7875533981,515,20.8744752387,1010
NE,2020,7,18,15.62565132,453,26.1084279476,458,20.8958068584,911
NE,2020,7,19,11.60117902,441,29.1847247706,436,20.3428277626,877
NE,2020,7,20,7.314576272,531,22.2237471783,443,14.0956468177,974
NE,2020,7,21,6.407659151,534,21.8939370079,508,13.957591158,1042
NE,2020,7,22,12.8759602,552,16.0021771218,542,14.4247806494,1094
NE,2020,7,23,14.2117852,549,23.3585820896,536,18.7303871657,1085
NE,2020,7,24,14.6022486,507,22.9916104869,534,18.9057253028,1041
NE,2020,7,25,13.15345495,466,27.5181620553,506,20.6313786077,972
NE,2020,7,26,22.56421988,455,37.2069230769,442,29.7794649336,897
NE,2020,7,27,17.21210248,528,26.2193983402,482,21.5106337717,1010
NE,2020,7,28,10.86093278,536,18.9344282744,481,14.6793706687,1017
NE,2020,7,29,14.21227273,550,23.340707635,537,18.7219043252,1087
NE,2020,7,30,12.66835214,534,18.24224,500,15.3636557474,1034
NE,2020,7,31,16.03312515,480,19.7999220273,513,17.9791138691,993
NH,2020,1,1,23.12105643,284,46.7728571429,280,34.8630851527,564
NH,2020,1,2,12.85516128,279,28.4716030534,262,20.4180221758,541
NH,2020,1,3,27.9458302,295,29.5160344828,290,28.7242220667,585
NH,2020,1,4,19.17425679,296,26.7245209581,334,23.1770952537,630
NH,2020,1,5,18.51036162,249,23.9415302491,281,21.3899057422,530
NH,2020,1,6,14.32924878,253,27.8138461538,247,20.9906398827,500
NH,2020,1,7,7.60034487,261,14.4195901639,244,10.8951881407,505
NH,2020,1,8,18.56110678,271,25.5112184874,238,21.8108643171,509
NH,2020,1,9,32.49956363,275,34.6054716981,265,33.5330185153,540
NH,2020,1,10,26.54597896,286,27.7844363636,275,27.1530659226,561
NH,2020,1,11,18.79438526,301,26.0780066445,301,22.4361959523,602
NH,2020,1,12,18.48419237,291,20.5110714286,280,19.4781085458,571
NH,2020,1,13,12.32801351,297,15.4936013986,286,13.8809434176,583
NH,2020,1,14,16.18941189,238,25.244375,320,21.3822222757,558
NH,2020,1,15,15.08353478,215,10.2641340782,179,12.8940100957,394
NH,2020,1,16,14.04886738,309,19.4557195572,271,16.575172449,580
NH,2020,1,17,28.89019501,308,24.8362578616,318,26.8308467461,626
NH,2020,1,18,16.56402592,308,45.3260702875,313,31.0608373323,621
NH,2020,1,19,19.60032239,279,20.1016718266,323,19.8693188485,602
NH,2020,1,20,18.19009714,308,26.9119860627,287,22.3971259145,595
NH,2020,1,21,8.994370839,302,16.0357003257,307,12.5439408758,609
NH,2020,1,22,13.4311227,285,18.1364310954,283,15.775492904,568
NH,2020,1,23,18.57161965,284,16.6835820896,268,17.654963733,552
NH,2020,1,24,30.83367533,302,17.2188405797,276,24.3324739613,578
NH,2020,1,25,15.07006411,312,21.4547854785,303,18.2157073208,615
NH,2020,1,26,19.84352955,289,17.118757764,322,18.4075614402,611
NH,2020,1,27,12.75971935,285,21.647080292,274,17.1159570926,559
NH,2020,1,28,22.11822949,288,30.8764705882,289,26.5049395028,577
NH,2020,1,29,13.84449664,298,28.6041877256,277,20.9548173891,575
NH,2020,1,30,12.40284319,306,16.8675618375,283,14.5480305877,589
NH,2020,1,31,23.81309795,326,22.36075,320,23.0936686249,646
NH,2020,2,1,23.70971062,346,29.9342406877,349,26.8354098914,695
NH,2020,2,2,19.84795117,205,15.4956873315,371,17.0446701213,576
NH,2020,2,3,40.46571399,189,10.6111034483,145,27.5048800722,334
NH,2020,2,4,9.630333383,330,15.1955031447,318,12.3613889142,648
NH,2020,2,5,20.69457535,365,19.3454347826,368,20.0172442057,733
NH,2020,2,6,31.20729601,233,17.9926851852,324,23.5205205931,557
NH,2020,2,7,20.68525246,297,12.8509954751,221,17.3428378004,518
NH,2020,2,8,30.85445477,541,24.6642940039,517,27.8295841499,1058
NH,2020,2,9,25.64218629,526,43.2076811594,552,34.6367625126,1078
NH,2020,2,10,22.33241489,617,26.8255166052,542,24.43358929,1159
NH,2020,2,11,28.18164144,463,42.1498011364,704,36.6080205542,1167
NH,2020,2,12,38.39940387,302,70.7894720497,322,55.1135095653,624
NH,2020,2,13,17.97919304,285,28.5912027491,291,23.3404687785,576
NH,2020,2,14,26.56407397,297,15.9652464789,284,21.3832357471,581
NH,2020,2,15,23.65224552,285,27.3468253968,252,25.3860148477,537
NH,2020,2,16,24.67242851,280,24.3347222222,252,24.5124623737,532
NH,2020,2,17,20.62878052,287,23.9477060932,279,22.2647880022,566
NH,2020,2,18,19.34783216,286,22.0056015038,266,20.6285688365,552
NH,2020,2,19,23.08673981,319,14.2015333333,300,18.7805008068,619
NH,2020,2,20,16.01077475,284,25.5194699647,283,20.7567372646,567
NH,2020,2,21,26.85978725,282,22.4175824176,273,24.6747027108,555
NH,2020,2,22,19.11948822,254,26.6505539359,343,23.4463819227,597
NH,2020,2,23,16.14791664,240,31.3633333333,246,23.8495473119,486
NH,2020,2,24,9.601515143,231,28.2041588785,214,18.5475056136,445
NH,2020,2,25,14.01294115,238,21.6338429752,242,17.8551458202,480
NH,2020,2,26,9.006188471,244,23.551375,240,16.2186776589,484
NH,2020,2,27,22.51548385,279,23.0436324786,234,22.7563937508,513
NH,2020,2,28,24.23573342,300,27.1630943396,265,25.6087434088,565
NH,2020,2,29,29.02063889,266,28.7484172662,278,28.8815256337,544
NH,2020,3,1,21.14788228,255,33.60046875,256,27.3863600419,511
NH,2020,3,2,11.72944658,271,26.5762641509,265,19.0697575059,536
NH,2020,3,3,16.2758706,293,34.9998518519,270,25.2553997972,563
NH,2020,3,4,17.23384624,286,15.0620727273,275,16.1692513808,561
NH,2020,3,5,11.23550733,276,16.0582641509,265,13.5978558652,541
NH,2020,3,6,14.28496244,266,34.4276691729,266,24.3563158065,532
NH,2020,3,7,31.700775,271,24.2422222222,261,28.0415977914,532
NH,2020,3,8,15.67619378,268,20.6609885932,263,18.1451222844,531
NH,2020,3,9,13.56468506,254,25.5428682171,258,19.6005664165,512
NH,2020,3,10,18.98843436,281,30.9277777778,252,24.6333021673,533
NH,2020,3,11,7.153942339,312,20.2016906475,278,13.3018644233,590
NH,2020,3,12,16.95406258,320,17.0618507463,335,17.0091908788,655
NH,2020,3,13,15.46274934,291,36.3951923077,312,26.2934660994,603
NH,2020,3,14,12.89561285,310,11.9664026403,303,12.4363131868,613
NH,2020,3,15,11.84826803,306,10.6787762238,286,11.283277056,592
NH,2020,3,16,13.82318447,336,22.2414935065,308,17.8493322701,644
NH,2020,3,17,13.3210434,345,9.82798245614,342,11.5821396987,687
NH,2020,3,18,9.671540674,318,17.0458917197,314,13.3353796429,632
NH,2020,3,19,12.66690983,343,19.6678289474,304,15.9563679624,647
NH,2020,3,20,5.084985829,355,8.23523364486,321,6.58088752854,676
NH,2020,3,21,9.495290633,327,19.565,316,14.4440124992,643
NH,2020,3,22,7.809966964,302,11.204137931,290,9.47265206609,592
NH,2020,3,23,5.4624465,327,12.5595904437,293,8.81641936371,620
NH,2020,3,24,4.883741939,310,9.96409090909,308,7.41569579464,618
NH,2020,3,25,3.837957286,328,17.1717301038,289,10.083435964,617
NH,2020,3,26,6.757078285,332,7.08413793103,319,6.91734253551,651
NH,2020,3,27,4.934367047,316,12.6231661442,319,8.79692911315,635
NH,2020,3,28,4.145211201,284,19.2548780488,287,11.7397372698,571
NH,2020,3,29,2.927229732,296,18.4471034483,290,10.6077133117,586
NH,2020,3,30,4.920963497,301,20.2508960573,279,12.2951896769,580
NH,2020,3,31,3.490786135,318,14.0718518519,297,8.60066665192,615
NH,2020,4,1,3.438580445,317,7.94859106529,291,5.59715460701,608
NH,2020,4,2,6.721967176,305,9.70408163265,294,8.185642719,599
NH,2020,4,3,4.48560888,271,8.79160409556,293,6.72258866397,564
NH,2020,4,4,5.304065866,273,12.6366423358,274,8.97705663879,547
NH,2020,4,5,10.45785451,275,5.56524344569,267,8.04765680858,542
NH,2020,4,6,6.846292467,294,16.3769672131,244,11.1687546195,538
NH,2020,4,7,5.370670925,313,10.5953191489,282,7.8468907555,595
NH,2020,4,8,7.040653948,260,8.71694352159,301,7.94005352314,561
NH,2020,4,9,3.184666666,255,11.3036936937,222,6.96333333298,477
NH,2020,4,10,4.964743099,253,7.50073469388,245,6.21236948604,498
NH,2020,4,11,6.021140651,263,6.81703252033,246,6.40579566054,509
NH,2020,4,12,2.633086435,243,7.60484,250,5.1542596424,493
NH,2020,4,13,7.489087431,263,6.51076628352,261,7.00179388235,524
NH,2020,4,14,4.917309081,275,16.141598513,269,10.467555142,544
NH,2020,4,15,11.28078235,294,11.4502390438,251,11.3588257081,545
NH,2020,4,16,7.00329938,294,22.7932312925,294,14.8982653363,588
NH,2020,4,17,4.503970631,272,13.6513868613,274,9.09443225574,546
NH,2020,4,18,2.631888905,270,5.61352490421,261,4.09743880292,531
NH,2020,4,19,4.855793402,271,7.14648148148,270,5.99902035479,541
NH,2020,4,20,5.047464386,280,6.43303501946,257,5.71057733348,537
NH,2020,4,21,4.509722241,288,16.5998832685,257,10.2109541384,545
NH,2020,4,22,5.266478478,301,6.31700374532,267,5.76029933429,568
NH,2020,4,23,4.467197198,289,14.9042105263,266,9.46944142382,555
NH,2020,4,24,12.22611111,252,19.3798901099,273,15.9460761899,525
NH,2020,4,25,3.532651173,215,6.28216101695,236,4.9714190736,451
NH,2020,4,26,4.878444336,225,8.14458937198,207,6.44347216574,432
NH,2020,4,27,3.836926296,244,15.752,230,9.61850214393,474
NH,2020,4,28,8.824318987,257,5.93115879828,233,7.44859179522,490
NH,2020,4,29,5.107272794,253,17.5743071161,267,11.5086154171,520
NH,2020,4,30,3.915040003,250,30.2250622407,241,16.8289205718,491
NH,2020,5,1,8.444023539,256,13.0319047619,252,10.719901626,508
NH,2020,5,2,4.461702137,235,9.01662280702,228,6.70473002634,463
NH,2020,5,3,7.591048333,248,9.56907488987,227,8.53633681386,475
NH,2020,5,4,7.110496188,262,7.61198347107,242,7.35128968503,504
NH,2020,5,5,9.487849093,265,7.82278481013,237,8.70175300726,502
NH,2020,5,6,5.10123081,260,10.8399215686,255,7.94271846718,515
NH,2020,5,7,15.29657044,242,16.6154661017,236,15.947740683,478
NH,2020,5,8,10.61643415,258,10.6579518072,249,10.6368244787,507
NH,2020,5,9,13.98865296,245,9.3793220339,236,11.7271101356,481
NH,2020,5,10,9.995720185,236,26.5198275862,232,18.187158042,468
NH,2020,5,11,5.269871212,233,20.7007048458,227,12.8846521574,460
NH,2020,5,12,7.031604948,243,8.93328947368,228,7.95216561011,471
NH,2020,5,13,4.127851229,242,7.82209677419,248,5.99759183147,490
NH,2020,5,14,6.613474994,259,7.37200956938,209,6.95222227232,468
NH,2020,5,15,16.09257566,264,11.9659259259,270,14.0060673675,534
NH,2020,5,16,9.727071111,239,9.445,228,9.58935759214,467
NH,2020,5,17,7.049342093,228,7.84030042918,233,7.449110623,461
NH,2020,5,18,5.564408222,245,10.6584810127,237,8.06917015434,482
NH,2020,5,19,10.6357086,247,8.60243243243,222,9.67326231173,469
NH,2020,5,20,11.21447581,248,8.27433476395,233,9.79024948208,481
NH,2020,5,21,6.638056739,247,26.2642323651,241,16.3304918331,488
NH,2020,5,22,5.625324642,231,9.36418803419,234,7.50681718775,465
NH,2020,5,23,11.65796389,221,10.2243859649,228,10.9300000439,449
NH,2020,5,24,9.930598267,234,23.5450420168,238,16.7955084629,472
NH,2020,5,25,6.954763991,233,7.32911504425,226,7.1390849889,459
NH,2020,5,26,4.880894877,257,5.77052631579,228,5.29911336781,485
NH,2020,5,27,5.65679684,256,7.76087336245,229,6.65026802276,485
NH,2020,5,28,5.924030877,258,11.9631718062,227,8.75059786859,485
NH,2020,5,29,7.018440019,250,10.3609677419,279,8.7813232604,529
NH,2020,5,30,7.970641105,234,6.9047983871,248,7.42224070243,482
NH,2020,5,31,7.772362202,254,10.0705577689,251,8.914633662,505
NH,2020,6,1,2.693880009,250,18.5395454545,264,10.832509732,514
NH,2020,6,2,6.026983442,242,8.15233201581,253,7.11327271306,495
NH,2020,6,3,4.494103604,251,10.7819148936,235,7.53450618231,486
NH,2020,6,4,10.82821698,258,10.3768199234,261,10.6012138359,519
NH,2020,6,5,13.83784085,264,8.39954918033,244,11.2257480008,508
NH,2020,6,6,10.29575303,259,10.7596240602,266,10.5307810186,525
NH,2020,6,7,5.420588212,238,15.8660619469,226,10.5082542984,464
NH,2020,6,8,12.54004351,229,9.40027906977,215,11.0196620806,444
NH,2020,6,9,15.99594845,232,13.040657277,213,14.5813933492,445
NH,2020,6,10,5.732017083,233,22.2589082969,229,13.9239177064,462
NH,2020,6,11,7.818171078,257,8.20779467681,263,8.01523070586,520
NH,2020,6,12,10.71645742,223,10.2130357143,224,10.4641834556,447
NH,2020,6,13,8.73407081,226,8.9868202765,217,8.85787811074,443
NH,2020,6,14,7.371659371,229,16.3964732143,224,11.8342604767,453
NH,2020,6,15,4.18542602,223,33.1847783251,203,18.004366203,426
NH,2020,6,16,6.437660547,218,20.7616964286,224,13.6969004508,442
NH,2020,6,17,14.0585478,241,10.0453140097,207,12.2042187942,448
NH,2020,6,18,10.29587304,252,9.66574898785,247,9.98396794806,499
NH,2020,6,19,16.47027977,250,11.2055882353,238,13.9026638166,488
NH,2020,6,20,15.76615371,260,17.9256153846,260,16.8458845473,520
NH,2020,6,21,13.99969159,227,31.5503719008,242,23.0556929444,469
NH,2020,6,22,12.54155647,212,9.69534562212,217,11.1018647358,429
NH,2020,6,23,10.484389,221,10.3083193277,238,10.3930936144,459
NH,2020,6,24,13.52535411,226,9.01055276382,199,11.4113647738,425
NH,2020,6,25,13.55941848,258,15.6547272727,220,14.5237865436,478
NH,2020,6,26,8.082216756,203,12.5528571429,245,10.5270982176,448
NH,2020,6,27,13.44803486,229,42.2796460177,226,27.7687911713,455
NH,2020,6,28,7.345375052,240,19.53975,240,13.442562526,480
NH,2020,6,29,11.63411254,231,16.9266071429,224,14.2396483445,455
NH,2020,6,30,9.430373824,214,23.9992792793,222,16.8484862347,436
NH,2020,7,1,8.034331708,217,13.4252521008,238,10.8541977596,455
NH,2020,7,2,19.56521911,251,32.0646696035,227,25.5011506205,478
NH,2020,7,3,12.53078072,269,28.6497580645,248,20.2629013804,517
NH,2020,7,4,18.07177689,242,11.9828870293,239,15.0463201817,481
NH,2020,7,5,9.793111091,225,19.0154867257,226,14.4145232716,451
NH,2020,7,6,13.35974379,234,12.7886343612,227,13.0785250474,461
NH,2020,7,7,12.68829177,240,25.1164125561,223,18.6741901184,463
NH,2020,7,8,21.01,243,24.8713716814,226,22.8707036247,469
NH,2020,7,9,23.99682173,236,16.352394958,238,20.1584808614,474
NH,2020,7,10,20.91011937,252,15.5988841202,233,18.35853625,485
NH,2020,7,11,10.3914978,227,12.3669230769,247,11.4208860772,474
NH,2020,7,12,18.33783898,236,12.3507079646,226,15.4090692625,462
NH,2020,7,13,14.03136339,242,13.4923706897,232,13.7675526168,474
NH,2020,7,14,8.094875085,240,30.139844358,257,19.494386359,497
NH,2020,7,15,7.350085884,233,28.9487826087,230,18.0794600669,463
NH,2020,7,16,9.355789518,247,12.0012916667,240,10.6595277432,487
NH,2020,7,17,12.69051795,251,12.9066071429,224,12.7924210641,475
NH,2020,7,18,16.60303814,237,13.7868584071,226,15.2284018125,463
NH,2020,7,19,9.90377876,217,30.0947345133,226,20.2043566386,443
NH,2020,7,20,6.046290354,248,12.9420481928,249,9.50110665552,497
NH,2020,7,21,12.97784604,260,19.317755102,245,16.0536435057,505
NH,2020,7,22,8.168695648,276,27.6218039216,255,17.510583802,531
NH,2020,7,23,6.837875467,273,11.1150757576,264,8.94063315175,537
NH,2020,7,24,15.73965521,261,14.464453125,256,15.1082205219,517
NH,2020,7,25,12.77008165,245,31.3484210526,247,22.0970122038,492
NH,2020,7,26,12.12560347,232,15.8490829694,229,13.9752277767,461
NH,2020,7,27,13.77770169,248,15.5701746725,229,14.6382390338,477
NH,2020,7,28,20.6878279,244,19.4559832636,239,20.0782815892,483
NH,2020,7,29,13.11989095,275,25.2888114754,244,18.8409248772,519
NH,2020,7,30,20.73235082,285,14.4454135338,266,17.6972776474,551
NH,2020,7,31,14.92988044,251,21.5839925373,268,18.3659152032,519
NJ,2020,1,1,20.48438257,3790,36.4457258515,3582,28.2398806213,7372
NJ,2020,1,2,16.47762713,3658,23.2433745365,3236,19.6534261737,6894
NJ,2020,1,3,17.58351861,3706,25.0816752725,3486,21.2179143449,7192
NJ,2020,1,4,15.51452024,3783,25.1269699596,3462,20.1077984911,7245
NJ,2020,1,5,17.20742358,3695,18.7577022922,3621,17.9747225435,7316
NJ,2020,1,6,15.48340984,3660,34.4110033547,3279,24.4275774628,6939
NJ,2020,1,7,11.58105142,3757,25.1542793988,3393,18.0221650608,7150
NJ,2020,1,8,13.98419143,3710,26.8359562842,3294,20.0284109374,7004
NJ,2020,1,9,17.79894002,3830,25.542260153,3398,21.4392003703,7228
NJ,2020,1,10,18.57088822,3535,22.4275259259,3375,20.4545571429,6910
NJ,2020,1,11,15.88953056,3600,26.168148263,3224,20.7456653013,6824
NJ,2020,1,12,16.25048555,3707,27.2932458234,3352,21.4941932191,7059
NJ,2020,1,13,16.55895637,3852,27.7743114468,3442,21.8514230789,7294
NJ,2020,1,14,12.5833159,3061,23.3280356621,3421,18.2540481286,6482
NJ,2020,1,15,16.10988143,2784,17.8093973799,2290,16.8769077456,5074
NJ,2020,1,16,17.05566601,3551,27.8485528404,3151,22.1300298421,6702
NJ,2020,1,17,19.08387914,3542,29.1301954198,3275,23.9102963054,6817
NJ,2020,1,18,13.61248098,3551,21.2385639767,3259,17.2620264258,6810
NJ,2020,1,19,16.31485136,3533,28.4584322034,3304,22.1832718817,6837
NJ,2020,1,20,21.34831055,3581,28.6808874046,3144,24.7763583761,6725
NJ,2020,1,21,14.57936322,3753,29.7867952612,3292,21.685518831,7045
NJ,2020,1,22,17.22096552,3656,19.6150682853,3295,18.3558480709,6951
NJ,2020,1,23,14.82956799,3565,25.5690504732,3170,19.8843800868,6735
NJ,2020,1,24,16.6978823,3466,27.0084093711,3244,21.6825842104,6710
NJ,2020,1,25,13.057625,3701,24.2351308232,3134,18.1827608083,6835
NJ,2020,1,26,13.80526343,3682,24.5431591387,3808,19.2645300333,7490
NJ,2020,1,27,13.82403219,3477,30.5852526596,3008,21.5985504895,6485
NJ,2020,1,28,13.40303008,3594,26.3571646535,3146,19.4495741999,6740
NJ,2020,1,29,15.0824042,3706,24.0569686936,3322,19.3245076786,7028
NJ,2020,1,30,16.88059123,3755,22.3728795644,3122,19.3739639477,6877
NJ,2020,1,31,18.34277876,3552,31.751281362,3348,24.8488174138,6900
NJ,2020,2,1,16.49040193,3707,30.6611526079,3106,22.95075003,6813
NJ,2020,2,2,14.94041456,2557,20.9317253981,3831,18.5335128413,6388
NJ,2020,2,3,17.44986478,2071,18.0455976676,1715,17.7197226517,3786
NJ,2020,2,4,8.7148659,3132,20.0017684128,2539,13.7681978485,5671
NJ,2020,2,5,10.36556614,3471,17.9961947431,3348,14.11206043,6819
NJ,2020,2,6,16.38396722,1651,22.4174949563,2974,20.2636886228,4625
NJ,2020,2,7,11.10791751,1868,9.14462962963,1188,10.3447021952,3056
NJ,2020,2,8,13.75056146,3491,19.692295557,3106,16.5480491219,6597
NJ,2020,2,9,15.70785301,3158,20.015843954,3217,17.8817834989,6375
NJ,2020,2,10,14.18959144,3255,20.9893506957,2803,17.3357989662,6058
NJ,2020,2,11,12.2631454,3033,24.0654237856,2985,18.117216683,6018
NJ,2020,2,12,14.28271101,3198,18.8884520493,2513,16.3093661023,5711
NJ,2020,2,13,16.44413701,3795,22.8833815385,3250,19.4146898443,7045
NJ,2020,2,14,16.54424155,3593,28.090237467,3411,22.1672272829,7004
NJ,2020,2,15,13.84842916,3323,23.9592115059,2955,18.6074864764,6278
NJ,2020,2,16,16.6035529,3355,19.8990879048,3026,18.1663626359,6381
NJ,2020,2,17,13.22209509,3451,30.0985831152,3056,21.1481051415,6507
NJ,2020,2,18,13.842551,3677,21.6364986737,3016,17.3546600967,6693
NJ,2020,2,19,15.02416112,3737,26.7100614754,3416,20.6049014547,7153
NJ,2020,2,20,18.07452224,3631,29.614876058,3308,23.5761061037,6939
NJ,2020,2,21,18.67436764,3455,28.361887287,3052,23.2181374207,6507
NJ,2020,2,22,17.38063847,3430,24.7415169405,3896,21.2951869986,7326
NJ,2020,2,23,17.5552326,3354,26.8253656937,3049,21.9695127503,6403
NJ,2020,2,24,16.17084249,3561,21.9908757704,3083,18.871499113,6644
NJ,2020,2,25,15.16199894,3627,33.4726341613,3261,23.8308406149,6888
NJ,2020,2,26,17.29412321,3621,24.3506842775,3142,20.572507784,6763
NJ,2020,2,27,18.48728119,3656,30.4872055641,3235,24.1206806023,6891
NJ,2020,2,28,18.07295387,3531,25.203985056,3212,21.4697909113,6743
NJ,2020,2,29,16.73009275,3344,26.6227232565,3169,21.5435037857,6513
NJ,2020,3,1,17.92842353,3343,26.3558726568,3094,21.9791502036,6437
NJ,2020,3,2,16.99788227,3617,23.7834577922,3080,20.11861881,6697
NJ,2020,3,3,14.27938146,3686,21.8580656358,3169,17.7829336341,6855
NJ,2020,3,4,19.2879246,3686,19.0910299625,3204,19.1963643071,6890
NJ,2020,3,5,15.5183247,3665,31.3455398339,3251,22.9582142894,6916
NJ,2020,3,6,18.12666759,3523,30.7855790747,3307,24.2559531361,6830
NJ,2020,3,7,16.47127744,3413,28.7380252101,3094,22.3039680195,6507
NJ,2020,3,8,19.18518681,3426,28.9932853797,2989,23.75516446,6415
NJ,2020,3,9,13.44341448,3532,30.4396718648,3078,21.3578592955,6610
NJ,2020,3,10,13.92138932,3750,19.1277898326,3226,16.3290510249,6976
NJ,2020,3,11,13.84679698,4143,20.6878923767,3568,17.0122785486,7711
NJ,2020,3,12,13.54218111,4053,29.4914848883,3805,21.265151443,7858
NJ,2020,3,13,13.10481315,3800,25.0829516749,3642,18.9667293698,7442
NJ,2020,3,14,12.50613989,3689,15.8208294931,3255,14.0599006414,6944
NJ,2020,3,15,14.30738175,3804,18.8493762634,3463,16.4718137026,7267
NJ,2020,3,16,10.86941091,4261,15.3348705758,3786,12.9703466991,8047
NJ,2020,3,17,10.67620505,4448,15.0710589978,4051,12.7709871823,8499
NJ,2020,3,18,9.850022823,4370,15.5271380645,3875,12.5181637036,8245
NJ,2020,3,19,8.648062058,4417,16.2968573589,3968,12.2676708539,8385
NJ,2020,3,20,7.097347461,4343,12.5422360248,4186,9.76967757335,8529
NJ,2020,3,21,6.638255108,4195,14.3517424435,3937,10.3726377494,8132
NJ,2020,3,22,6.197966682,4018,13.725625649,3852,9.88240662367,7870
NJ,2020,3,23,5.838160318,4180,7.99526036132,3764,6.86023037881,7944
NJ,2020,3,24,6.289490963,4361,11.9786942356,3990,9.0077188468,8351
NJ,2020,3,25,6.244315483,4463,15.3911610672,4048,10.5947362238,8511
NJ,2020,3,26,7.175876046,4372,16.4261379142,4104,11.6547664079,8476
NJ,2020,3,27,7.262058048,4033,14.3220686176,3964,10.7616056156,7997
NJ,2020,3,28,5.042480666,4007,11.3855318582,3751,8.10935164071,7758
NJ,2020,3,29,6.238577487,4042,13.8939625545,3899,9.99734167012,7941
NJ,2020,3,30,6.553058664,4162,11.8862893244,3878,9.12548011935,8040
NJ,2020,3,31,6.260138388,4264,16.2432523511,3828,10.9827484042,8092
NJ,2020,4,1,7.238879086,4300,13.4162109955,4038,10.230491733,8338
NJ,2020,4,2,4.658247738,4166,17.7474888011,3795,10.8978746485,7961
NJ,2020,4,3,6.118482216,3907,14.8359435442,3826,10.431556966,7733
NJ,2020,4,4,5.137455277,3800,15.8298848369,3647,10.37383108,7447
NJ,2020,4,5,6.419649497,3737,10.590974026,3542,8.44943813303,7279
NJ,2020,4,6,4.683998471,3819,9.5977258567,3531,7.04459321915,7350
NJ,2020,4,7,4.536324704,4065,13.911810089,3707,9.00813689163,7772
NJ,2020,4,8,5.83549371,3646,12.2291159496,3812,9.10345938142,7458
NJ,2020,4,9,7.238170263,3547,14.3461270945,3163,10.5887615384,6710
NJ,2020,4,10,6.713086644,3729,11.4128794208,3591,9.01868170703,7320
NJ,2020,4,11,4.739404968,3630,13.2569785693,3313,8.80374622409,6943
NJ,2020,4,12,6.608203453,3707,14.5059165468,3475,10.4295001671,7182
NJ,2020,4,13,5.505310983,3843,9.26924943567,3544,7.31110465787,7387
NJ,2020,4,14,5.944828692,3852,10.9026655396,3549,8.3222591706,7401
NJ,2020,4,15,6.122393841,3910,9.34943786167,3629,7.67577529093,7539
NJ,2020,4,16,5.102309516,3832,14.8259455782,3675,9.86244839021,7507
NJ,2020,4,17,5.612896027,3674,11.0924546722,3585,8.31908389629,7259
NJ,2020,4,18,5.880281806,3549,11.3224634775,3491,8.57895456385,7040
NJ,2020,4,19,6.104362628,3491,8.80617166617,3367,7.43084134359,6858
NJ,2020,4,20,6.424969796,3640,10.7481450654,3364,8.50137779232,7004
NJ,2020,4,21,5.862328466,3818,9.06624212936,3494,7.3933014337,7312
NJ,2020,4,22,6.443142749,3987,11.0959595392,3559,8.6376000716,7546
NJ,2020,4,23,6.116278927,4109,13.3909064786,3828,9.62481795528,7937
NJ,2020,4,24,5.258873026,3709,14.6676623725,3726,9.97402421701,7435
NJ,2020,4,25,5.216829784,3372,10.9125030713,3256,8.01482498969,6628
NJ,2020,4,26,5.677280319,3357,10.1373447607,3092,7.81567685391,6449
NJ,2020,4,27,6.742215558,3498,12.9279750779,3210,9.70230620481,6708
NJ,2020,4,28,4.810707126,3578,9.85197213622,3230,7.20249413878,6808
NJ,2020,4,29,4.795481782,3570,8.97577750461,3254,6.7888408502,6824
NJ,2020,4,30,4.716101477,3627,14.0273495744,3407,9.22611317274,7034
NJ,2020,5,1,6.60404792,3508,12.1815595568,3610,9.43276624099,7118
NJ,2020,5,2,6.392837476,3274,13.9567988487,3127,10.0879643644,6401
NJ,2020,5,3,5.717286396,3324,12.9676882777,3054,9.18902163379,6378
NJ,2020,5,4,7.34507031,3625,13.9600902583,3213,10.4532977294,6838
NJ,2020,5,5,5.898930378,3534,14.5189646621,3226,10.012573958,6760
NJ,2020,5,6,6.95461807,3521,14.5739674895,3322,10.6535043438,6843
NJ,2020,5,7,6.501472579,3538,15.480115889,3279,10.8202303043,6817
NJ,2020,5,8,7.252599539,3316,12.3890449954,3267,9.80170591999,6583
NJ,2020,5,9,7.987013,3311,10.296961039,3080,9.10024097058,6391
NJ,2020,5,10,9.271996329,3261,15.243081803,2995,12.1305962322,6256
NJ,2020,5,11,8.066161747,3327,16.6185350529,3024,12.138335716,6351
NJ,2020,5,12,6.335124946,3362,13.1641736876,3086,9.60349411732,6448
NJ,2020,5,13,5.667699454,3134,13.3705434429,3073,9.48127115979,6207
NJ,2020,5,14,6.488559053,3116,16.1443895242,2711,10.980914709,5827
NJ,2020,5,15,7.495377912,3215,14.6750080828,3093,11.015764107,6308
NJ,2020,5,16,6.813156374,3127,17.110625,2928,11.7926754718,6055
NJ,2020,5,17,7.962874135,3114,11.7186648408,2921,9.7807141767,6035
NJ,2020,5,18,7.320423318,3260,12.9577962164,3013,10.0281237074,6273
NJ,2020,5,19,6.058301098,3308,9.99813542021,2939,7.91185849723,6247
NJ,2020,5,20,7.00898245,3361,17.1351532753,3099,11.8667229125,6460
NJ,2020,5,21,8.441301779,3380,14.7564138607,3059,11.4414458787,6439
NJ,2020,5,22,7.984716283,3172,11.5907333333,3150,9.78145049821,6322
NJ,2020,5,23,7.066251313,2985,18.1430530669,2902,12.5265670408,5887
NJ,2020,5,24,6.360352419,3036,14.3724857955,2816,10.2158150964,5852
NJ,2020,5,25,8.495416018,3089,17.4432885431,2828,12.7720060976,5917
NJ,2020,5,26,7.944178575,3147,18.8554576387,2939,13.21336181,6086
NJ,2020,5,27,8.107933288,3266,14.6272042278,2933,11.192466546,6199
NJ,2020,5,28,6.710199022,3467,15.1183124397,3111,10.686733051,6578
NJ,2020,5,29,8.506947033,3305,13.1569981807,3298,10.829507791,6603
NJ,2020,5,30,7.78240409,3232,12.3244282475,3087,10.0013040068,6319
NJ,2020,5,31,9.07091849,3277,17.6225982462,3079,13.213558825,6356
NJ,2020,6,1,8.391710911,3507,16.1537028088,3311,12.1611381879,6818
NJ,2020,6,2,6.308496649,3399,11.6407601301,3381,8.96755016371,6780
NJ,2020,6,3,8.546091688,3339,13.2915640394,3248,10.8860482991,6587
NJ,2020,6,4,7.545666495,3286,15.0408086785,3042,11.1487357937,6328
NJ,2020,6,5,6.57309949,2965,12.4931448186,3059,9.57931108696,6024
NJ,2020,6,6,7.074742466,2796,18.2558748636,2749,12.6179224409,5545
NJ,2020,6,7,8.181312006,2782,16.0865526122,2718,12.0879381819,5500
NJ,2020,6,8,7.359291338,2935,14.766928839,2670,10.8879964455,5605
NJ,2020,6,9,8.8297171,3146,18.1630907209,2899,13.3057220838,6045
NJ,2020,6,10,9.390626226,3114,16.1828209638,2843,12.632225964,5957
NJ,2020,6,11,7.006963669,3053,17.1722682513,2945,11.9980977128,5998
NJ,2020,6,12,9.741901861,2792,14.6433041256,2739,12.1691195075,5531
NJ,2020,6,13,9.287668355,2822,14.9313892168,2541,11.9616744542,5363
NJ,2020,6,14,8.973066551,2886,13.6421195453,2727,11.2414626877,5613
NJ,2020,6,15,10.30694211,2989,16.0889650198,2773,13.0895782657,5762
NJ,2020,6,16,9.228861068,3073,18.8999606581,2796,13.8361867545,5869
NJ,2020,6,17,8.662356493,3153,13.2549662282,2813,10.8277958469,5966
NJ,2020,6,18,8.377159828,3204,20.3582452004,2969,14.1396484835,6173
NJ,2020,6,19,10.53380651,2966,15.6220890989,2963,13.0766605007,5929
NJ,2020,6,20,10.71512173,2999,17.1642386069,2699,13.7699069969,5698
NJ,2020,6,21,12.08790289,3047,20.8575789474,2945,16.3980991498,5992
NJ,2020,6,22,10.42652653,3092,17.0554177215,2765,13.55592454,5857
NJ,2020,6,23,7.97042298,3097,18.6694586098,2863,13.1099093908,5960
NJ,2020,6,24,8.37922282,2998,18.423229431,2759,13.1927392764,5757
NJ,2020,6,25,10.6002341,3033,17.5233523335,2807,13.9278356208,5840
NJ,2020,6,26,11.99199596,2916,16.4380612613,2775,14.1599508381,5691
NJ,2020,6,27,9.923289362,2955,22.2322915129,2710,15.811620488,5665
NJ,2020,6,28,10.63042574,3030,20.7759439796,2749,15.4565253491,5779
NJ,2020,6,29,10.19275242,3139,20.7748158541,2851,15.2293906254,5990
NJ,2020,6,30,9.338915018,2931,18.9722789116,2940,14.1629807388,5871
NJ,2020,7,1,11.11928737,2947,15.2104955437,2805,13.114391495,5752
NJ,2020,7,2,10.6464211,3054,23.6762410842,2804,16.8832963536,5858
NJ,2020,7,3,12.84041969,3050,16.6611806543,2812,14.6732378121,5862
NJ,2020,7,4,10.45324639,2837,15.4978092506,2789,12.9540081778,5626
NJ,2020,7,5,11.65773804,2878,17.4396796604,2591,14.3969976374,5469
NJ,2020,7,6,11.13269612,3008,15.8584729586,2829,13.4231231675,5837
NJ,2020,7,7,8.012704475,3069,19.3187390849,2863,13.4694099855,5932
NJ,2020,7,8,8.368161142,3165,16.7205231742,2848,12.3241776176,6013
NJ,2020,7,9,11.61340522,3201,18.208941836,2854,14.7221849891,6055
NJ,2020,7,10,11.82785878,3045,22.1322432432,2960,16.9071223955,6005
NJ,2020,7,11,9.803519023,2890,20.226863948,2771,14.9056368091,5661
NJ,2020,7,12,12.52610213,2899,17.1206358164,2658,14.7237394412,5557
NJ,2020,7,13,10.29426797,3053,21.747098465,2671,15.6385220322,5724
NJ,2020,7,14,8.822456991,3138,18.4148170515,2815,13.3584041723,5953
NJ,2020,7,15,11.08530084,3092,17.2400983146,2848,14.036287912,5940
NJ,2020,7,16,11.39816586,3075,17.0073456121,2769,14.0559034941,5844
NJ,2020,7,17,12.05024185,2936,18.2126086957,2806,15.0616666791,5742
NJ,2020,7,18,10.96814931,2853,20.1606599926,2697,15.4352126093,5550
NJ,2020,7,19,11.8457613,2916,20.6036903861,2642,16.008850297,5558
NJ,2020,7,20,9.073031876,3107,21.6175308207,2839,15.0625765285,5946
NJ,2020,7,21,9.486275298,3160,14.5703390435,2802,11.8756658741,5962
NJ,2020,7,22,12.38656252,3264,16.5088044254,2802,14.2907039343,6066
NJ,2020,7,23,12.70203977,3319,17.8719817471,3068,15.1854250817,6387
NJ,2020,7,24,12.19245783,3023,22.0706511142,2872,17.0050398677,5895
NJ,2020,7,25,10.39330888,2862,16.9930714818,2686,13.5885075729,5548
NJ,2020,7,26,11.29641032,2822,18.0757142857,2632,14.567977617,5454
NJ,2020,7,27,9.430553944,3087,17.6224130355,2731,13.2758559686,5818
NJ,2020,7,28,7.500809415,3101,19.047121631,2894,13.0746255206,5995
NJ,2020,7,29,10.6469199,3185,19.4759011731,2813,14.7876208539,5998
NJ,2020,7,30,9.849550157,3201,18.0476073211,3005,13.8191218261,6206
NJ,2020,7,31,11.58346872,2831,18.5290371915,2877,15.0842396542,5708
NM,2020,1,1,40.13622825,692,41.5744390244,615,40.8129685914,1307
NM,2020,1,2,38.64700626,658,48.9823465704,554,43.3712459728,1212
NM,2020,1,3,37.12993607,626,36.3145,600,36.7308645839,1226
NM,2020,1,4,37.47254284,641,34.0610881801,533,35.9237308011,1174
NM,2020,1,5,40.86658723,671,33.5989824561,570,37.528525408,1241
NM,2020,1,6,38.15363065,628,36.9994485294,544,37.617901065,1172
NM,2020,1,7,36.79321653,628,46.012368932,515,40.9470778485,1143
NM,2020,1,8,39.84517242,667,36.8344237918,538,38.5009543603,1205
NM,2020,1,9,34.25330697,629,37.4775752212,565,35.7790285462,1194
NM,2020,1,10,32.17768327,600,29.5317318436,537,30.9280122797,1137
NM,2020,1,11,33.11344997,629,33.9893346774,496,33.4996178054,1125
NM,2020,1,12,40.31128984,659,30.6528702011,547,35.9305638512,1206
NM,2020,1,13,35.83340021,650,27.6152430556,576,31.9723410575,1226
NM,2020,1,14,24.94506528,458,26.5048623853,545,25.7926120621,1003
NM,2020,1,15,29.34766605,437,20.5289020772,337,25.5079716587,774
NM,2020,1,16,35.89582279,632,32.9503144654,477,34.6289089299,1109
NM,2020,1,17,36.61422052,635,29.4605882353,544,33.3134775489,1179
NM,2020,1,18,29.50580316,579,28.756693712,493,29.1612966694,1072
NM,2020,1,19,40.20047241,635,26.2051009174,545,33.7365084579,1180
NM,2020,1,20,38.77762264,694,23.6223207547,530,32.2152778694,1224
NM,2020,1,21,31.10921928,666,31.397890223,583,31.2439632029,1249
NM,2020,1,22,29.63883142,659,30.6870804196,572,30.1259138146,1231
NM,2020,1,23,33.67496244,665,25.6194545455,550,30.0284362326,1215
NM,2020,1,24,33.09346209,621,38.6861100917,545,35.7075214047,1166
NM,2020,1,25,32.46523021,652,30.9935778175,559,31.7859125491,1211
NM,2020,1,26,35.7139357,653,28.8339836066,610,32.3910768108,1263
NM,2020,1,27,28.99222392,670,26.27518591,511,27.8166045948,1181
NM,2020,1,28,33.01647409,709,23.1757638889,576,28.605385315,1285
NM,2020,1,29,28.56043121,719,27.5991404959,605,28.1211707251,1324
NM,2020,1,30,33.85770583,680,26.9592359932,589,30.6558155748,1269
NM,2020,1,31,38.13246995,664,22.7276237624,606,30.7818110605,1270
NM,2020,2,1,40.07072123,721,41.9097321429,560,40.8746604269,1281
NM,2020,2,2,19.75671504,414,30.0644290123,648,26.0461676333,1062
NM,2020,2,3,25.52457973,345,22.7935069444,288,24.2820063299,633
NM,2020,2,4,28.86723139,661,17.5203118908,513,23.9089948456,1174
NM,2020,2,5,32.1373859,658,21.8422431259,691,26.863891714,1349
NM,2020,2,6,30.77847113,314,35.6499405941,505,33.7822465627,819
NM,2020,2,7,19.61957954,333,27.9067788462,208,22.8057855579,541
NM,2020,2,8,32.0195888,608,26.4710163339,551,29.3817428735,1159
NM,2020,2,9,30.55443474,575,27.9477022059,544,29.2871760282,1119
NM,2020,2,10,30.69832511,597,23.8095088409,509,27.5279747655,1106
NM,2020,2,11,28.61710156,590,15.3131150442,565,22.1090908402,1155
NM,2020,2,12,29.54439706,589,28.2708760684,468,28.9805296768,1057
NM,2020,2,13,36.45752362,743,31.8136581197,585,34.4118449169,1328
NM,2020,2,14,43.00014778,677,36.9072089314,627,40.0704908336,1304
NM,2020,2,15,38.60248066,645,27.0725939177,559,33.2493189582,1204
NM,2020,2,16,35.00303542,593,44.8536242884,527,39.6380892893,1120
NM,2020,2,17,33.72205076,629,35.2949227799,518,34.4323800593,1147
NM,2020,2,18,35.64631875,671,31.3661565836,562,33.6954256944,1233
NM,2020,2,19,26.933997,678,32.1545454545,594,29.3718946274,1272
NM,2020,2,20,35.47468503,651,27.5240837696,573,31.7527123812,1224
NM,2020,2,21,32.45691169,612,26.7110116732,514,29.834005288,1126
NM,2020,2,22,33.45640789,593,27.6468558282,652,30.4139758062,1245
NM,2020,2,23,43.98479264,578,29.601846473,482,37.4446227792,1060
NM,2020,2,24,35.66969961,666,38.3367567568,518,36.8365371117,1184
NM,2020,2,25,26.80196867,640,25.5605338078,562,26.2215307394,1202
NM,2020,2,26,31.1402073,627,26.6610233393,557,29.0330236293,1184
NM,2020,2,27,39.13349144,653,33.5358392857,560,36.54924972,1213
NM,2020,2,28,35.43610042,618,42.8838301887,530,38.874512247,1148
NM,2020,2,29,36.28616294,589,18.412756654,526,27.854403562,1115
NM,2020,3,1,43.31211701,633,20.9304703476,489,33.5575490796,1122
NM,2020,3,2,35.31312503,672,35.3367485822,529,35.3235304081,1201
NM,2020,3,3,33.6718613,634,26.858603352,537,30.5474210625,1171
NM,2020,3,4,37.18970962,620,27.0938121547,543,32.4759758937,1163
NM,2020,3,5,36.6971632,631,34.416345776,509,35.6787982274,1140
NM,2020,3,6,40.36733552,623,41.5211586453,561,40.9140371866,1184
NM,2020,3,7,37.12975037,561,28.5897307692,520,33.0216928377,1081
NM,2020,3,8,39.04844364,604,29.0554185022,454,34.7603213219,1058
NM,2020,3,9,27.49861415,635,26.9535326087,552,27.2451305689,1187
NM,2020,3,10,28.62702462,689,35.4703521127,568,31.7193158021,1257
NM,2020,3,11,31.80721133,814,28.5607184751,682,30.3271925285,1496
NM,2020,3,12,34.07459143,869,32.2025443038,790,33.1831404175,1659
NM,2020,3,13,36.8228493,723,40.0638504937,709,38.4275070139,1432
NM,2020,3,14,28.40561171,654,23.2348951049,572,25.9931729677,1226
NM,2020,3,15,28.11891334,635,33.6286779661,590,30.7725958946,1225
NM,2020,3,16,22.30061082,704,23.0348557692,624,22.6456174829,1328
NM,2020,3,17,26.78997305,739,27.5125154321,648,27.1275415169,1387
NM,2020,3,18,18.35144267,707,23.2086766917,665,20.7057142622,1372
NM,2020,3,19,16.94986607,747,21.5894871795,663,19.1314751449,1410
NM,2020,3,20,19.8593897,721,25.1798104956,686,22.4534257098,1407
NM,2020,3,21,15.92990628,640,30.4838924051,632,23.1611320906,1272
NM,2020,3,22,17.11327301,608,17.1307155323,573,17.1217358087,1181
NM,2020,3,23,14.38833839,668,20.4017133443,607,17.2511765055,1275
NM,2020,3,24,11.22839503,729,11.6837941628,651,11.4432246209,1380
NM,2020,3,25,13.16110538,760,15.0538473282,655,14.0372509461,1415
NM,2020,3,26,16.29200252,784,15.8272932331,665,16.0787301419,1449
NM,2020,3,27,16.97778721,705,19.9016216216,703,18.4376278289,1408
NM,2020,3,28,14.47363212,647,22.6150731707,615,18.4411331075,1262
NM,2020,3,29,15.33410304,641,23.1944217687,588,19.0947762804,1229
NM,2020,3,30,16.52365952,705,15.4281742044,597,16.021351737,1302
NM,2020,3,31,14.62971317,732,19.7301820941,659,17.0461107408,1391
NM,2020,4,1,8.56388646,687,17.3907496252,667,12.9121270296,1354
NM,2020,4,2,11.20823783,681,15.0036392405,632,13.0351180215,1313
NM,2020,4,3,9.147772498,633,25.7762460064,626,17.41578236,1259
NM,2020,4,4,9.942873632,602,22.6819928826,562,16.0935480468,1164
NM,2020,4,5,10.55654609,608,14.3206161972,568,12.3745663459,1176
NM,2020,4,6,11.4971638,684,17.1740901213,577,14.09477402,1261
NM,2020,4,7,15.61333792,722,18.3939937598,641,16.9210418036,1363
NM,2020,4,8,13.29631149,610,17.3239875389,642,15.3616214129,1252
NM,2020,4,9,16.07279996,575,14.5859009901,505,15.3775370157,1080
NM,2020,4,10,15.29011964,585,26.5530018416,543,20.7118794232,1128
NM,2020,4,11,13.54296289,594,18.1647680891,539,15.7416857517,1133
NM,2020,4,12,11.01325658,608,21.1345559846,518,15.6694138549,1126
NM,2020,4,13,12.81085932,640,20.9554166667,600,16.7517741652,1240
NM,2020,4,14,16.16996833,630,20.3666368515,559,18.1430025634,1189
NM,2020,4,15,13.0361477,623,19.9963001745,573,16.3707358003,1196
NM,2020,4,16,14.43120505,639,15.4196409336,557,14.8915384841,1196
NM,2020,4,17,17.00047115,573,22.5119413919,546,19.6897140026,1119
NM,2020,4,18,16.21646014,565,18.0487573964,507,17.0830410253,1072
NM,2020,4,19,14.29946363,578,12.67378,500,13.5454359723,1078
NM,2020,4,20,16.47642981,591,13.1353888889,540,14.8812378583,1131
NM,2020,4,21,14.14552544,590,15.8052268245,507,14.9125888875,1097
NM,2020,4,22,15.30954699,618,19.7011708253,521,17.3183582439,1139
NM,2020,4,23,12.28111277,638,19.5106291391,604,15.7969162216,1242
NM,2020,4,24,17.77413732,539,20.0468571429,560,18.9322111151,1099
NM,2020,4,25,14.87128713,505,18.8149891068,459,16.7490456438,964
NM,2020,4,26,13.13202706,518,20.1799148936,470,16.4847672238,988
NM,2020,4,27,14.93741996,562,17.9590103093,485,16.3371060339,1047
NM,2020,4,28,11.37562621,535,16.2667932489,474,13.6733597843,1009
NM,2020,4,29,13.22222023,581,21.9349525617,527,17.3662725213,1108
NM,2020,4,30,15.99902885,587,20.9907279693,522,18.3485932687,1109
NM,2020,5,1,16.4871898,548,27.7857345133,565,22.2227493355,1113
NM,2020,5,2,15.32024098,498,15.0247717842,482,15.1749183756,980
NM,2020,5,3,13.6848363,519,18.2195905172,464,15.8253510068,983
NM,2020,5,4,14.30908938,582,22.9626815642,537,18.4618856293,1119
NM,2020,5,5,13.59608247,582,29.3457915832,499,20.8662997202,1081
NM,2020,5,6,20.71273193,593,14.753467433,522,17.9228341117,1115
NM,2020,5,7,18.87564144,569,19.7980430528,511,19.312074055,1080
NM,2020,5,8,19.03365534,528,20.538120155,516,19.777241398,1044
NM,2020,5,9,16.88014743,543,19.130593047,489,17.9464923009,1032
NM,2020,5,10,18.86839456,517,21.2244558522,487,20.0112250872,1004
NM,2020,5,11,22.40935852,530,13.7621414538,509,18.1731376474,1039
NM,2020,5,12,15.72983811,556,21.3705656566,495,18.3865080772,1051
NM,2020,5,13,17.13030813,519,16.9018503937,508,17.0173027453,1027
NM,2020,5,14,15.66228102,491,21.55875,432,18.4220584841,923
NM,2020,5,15,16.43733821,541,27.0427689243,502,21.5417737024,1043
NM,2020,5,16,14.27071022,521,28.3931166348,523,21.3454406366,1044
NM,2020,5,17,13.14455429,516,13.4620600858,466,13.2952240465,982
NM,2020,5,18,18.19927231,536,22.4963354037,483,20.2360549148,1019
NM,2020,5,19,14.97118774,581,15.1548538012,513,15.0573126846,1094
NM,2020,5,20,15.86938512,553,25.8892843327,517,20.7107756742,1070
NM,2020,5,21,15.83966715,571,20.7028163265,490,18.085607863,1061
NM,2020,5,22,19.98589998,500,35.5180360721,499,27.7441941842,999
NM,2020,5,23,19.1258836,498,30.2915102975,437,24.3444706233,935
NM,2020,5,24,19.77492306,520,29.7447516199,463,24.4707833074,983
NM,2020,5,25,27.22633679,576,19.8941401274,471,23.9278987498,1047
NM,2020,5,26,18.01095767,543,24.250331384,513,21.0420170595,1056
NM,2020,5,27,20.57325092,566,26.1082708333,480,23.1132218171,1046
NM,2020,5,28,15.79944915,599,15.7967041199,534,15.7981553759,1133
NM,2020,5,29,19.13663143,567,14.9364937388,559,17.0514831446,1126
NM,2020,5,30,16.97595047,526,23.4703921569,510,20.1730211846,1036
NM,2020,5,31,25.65909581,553,18.6490466531,493,22.3551242667,1046
NM,2020,6,1,20.57094806,580,27.3928804348,552,23.897544059,1132
NM,2020,6,2,18.53845298,543,22.8253171642,536,20.6679795812,1079
NM,2020,6,3,18.53066658,525,22.1124282983,523,20.3181297276,1048
NM,2020,6,4,17.39057579,521,21.9780813953,516,19.6732690324,1037
NM,2020,6,5,24.34842834,509,19.0446666667,495,21.7335259214,1004
NM,2020,6,6,22.92070072,471,21.6932911392,474,22.3050476604,945
NM,2020,6,7,20.86208326,456,27.7577458034,417,24.1558877051,873
NM,2020,6,8,15.25423392,496,15.8938901099,455,15.560273422,951
NM,2020,6,9,18.54003817,524,21.0934279476,458,19.7309266813,982
NM,2020,6,10,18.22607916,505,17.8652965235,489,18.0485915249,994
NM,2020,6,11,21.79145701,501,24.4339832285,477,23.0802964847,978
NM,2020,6,12,24.69477084,480,31.6850209205,478,28.1825991683,958
NM,2020,6,13,30.25561169,474,29.7397355769,416,30.0144830798,890
NM,2020,6,14,23.73208164,490,21.5584787472,447,22.695154753,937
NM,2020,6,15,18.09180933,514,17.8950406504,492,17.9955765364,1006
NM,2020,6,16,18.96742746,517,29.6048414376,473,24.0497474715,990
NM,2020,6,17,22.77699076,545,27.1701232033,487,24.8501065545,1032
NM,2020,6,18,21.721217,567,32.5269521912,502,26.795565986,1069
NM,2020,6,19,25.70151816,527,30.6615662651,498,28.1113756784,1025
NM,2020,6,20,25.05571699,516,33.3892857143,476,29.0544858537,992
NM,2020,6,21,27.05249502,501,23.6875384615,455,25.4509728086,956
NM,2020,6,22,24.77113151,539,22.5935106383,470,23.756778874,1009
NM,2020,6,23,18.11378763,565,41.2767019027,473,28.668757236,1038
NM,2020,6,24,23.35332751,571,26.15125,480,24.6311608071,1051
NM,2020,6,25,19.9741481,540,23.9222664016,503,21.8781783068,1043
NM,2020,6,26,26.43872754,503,25.2997142857,490,25.8766766894,993
NM,2020,6,27,27.09423294,515,28.1670087336,458,27.5991983187,973
NM,2020,6,28,18.92358269,508,33.2471115974,457,25.7068497477,965
NM,2020,6,29,23.47899988,550,22.755177453,479,23.1420601885,1029
NM,2020,6,30,25.44596155,520,29.7713861386,505,27.5770243961,1025
NM,2020,7,1,27.86922798,544,22.7120507813,512,25.3687784291,1056
NM,2020,7,2,24.99604049,543,27.102209073,507,26.0130190344,1050
NM,2020,7,3,23.5995104,531,26.8622983871,496,25.1753067404,1027
NM,2020,7,4,21.00810421,480,26.0816326531,490,23.57102064,970
NM,2020,7,5,23.00070995,493,28.9003090508,453,25.8257822467,946
NM,2020,7,6,31.57881,563,28.8434334764,466,30.34004862,1029
NM,2020,7,7,26.17884286,579,17.958609407,489,22.4150842846,1068
NM,2020,7,8,19.37278181,568,20.6359266802,491,19.9584325478,1059
NM,2020,7,9,19.35676627,569,23.9447859922,514,21.5342751686,1083
NM,2020,7,10,24.5867361,576,36.6663817097,503,30.2179332656,1079
NM,2020,7,11,23.23628119,562,27.8566532258,496,25.4023535244,1058
NM,2020,7,12,24.20399996,540,25.2849685535,477,24.7110029286,1017
NM,2020,7,13,19.35706958,546,17.5043927126,494,18.477048068,1040
NM,2020,7,14,24.25649087,550,20.4418426501,483,22.4728751002,1033
NM,2020,7,15,20.86752215,565,20.0987148594,498,20.5073471446,1063
NM,2020,7,16,21.09681724,553,16.4945962733,483,18.9511871947,1036
NM,2020,7,17,25.86567932,530,26.7653996101,513,26.3082071329,1043
NM,2020,7,18,29.90485488,482,28.6577433628,452,29.301327679,934
NM,2020,7,19,23.50936709,490,27.005115304,477,25.2337434065,967
NM,2020,7,20,22.76240156,533,21.3131428571,420,22.1236936322,953
NM,2020,7,21,18.73616483,558,24.9444689379,499,21.6670482262,1057
NM,2020,7,22,21.47875233,569,14.4361257606,493,18.2094350996,1062
NM,2020,7,23,23.49549752,573,29.6594308943,492,26.343061107,1065
NM,2020,7,24,22.24887409,524,24.7763541667,480,23.4572310988,1004
NM,2020,7,25,23.71715119,509,26.2105627706,462,24.9035117978,971
NM,2020,7,26,28.17852888,503,25.6824835165,455,26.9930376061,958
NM,2020,7,27,32.70187859,543,27.19004329,462,30.168079676,1005
NM,2020,7,28,24.58352714,550,27.1664583333,480,25.7872232301,1030
NM,2020,7,29,25.23556162,552,26.9907322176,478,26.0500971012,1030
NM,2020,7,30,31.43586077,546,20.6849284254,489,26.3564347637,1035
NM,2020,7,31,32.86449917,509,19.1431612903,465,26.3137577798,974
NV,2020,1,1,31.05092974,2549,64.9609304892,2719,48.553073255,5268
NV,2020,1,2,28.70537083,2346,55.0713638465,2163,41.3533288905,4509
NV,2020,1,3,30.23354182,2383,61.2188466579,2289,45.4144841946,4672
NV,2020,1,4,25.12173085,2363,45.841465812,2340,35.4309334464,4703
NV,2020,1,5,35.83126513,2395,51.6215280801,2297,43.5614940295,4692
NV,2020,1,6,33.03186272,2652,47.2472772074,2435,39.836371129,5087
NV,2020,1,7,21.23967709,2880,52.5920766654,2687,36.3724052486,5567
NV,2020,1,8,22.47506534,2829,50.0259362101,2665,35.8392937472,5494
NV,2020,1,9,28.71846156,2691,61.7659728838,2729,45.3580664314,5420
NV,2020,1,10,39.17524409,2315,68.4885673816,2471,54.3096406328,4786
NV,2020,1,11,26.72254404,2217,64.5816751978,2149,45.357283586,4366
NV,2020,1,12,32.8917475,2186,51.5383985605,2223,42.2933136845,4409
NV,2020,1,13,24.97359272,2146,66.4106506365,2121,45.5707335311,4267
NV,2020,1,14,19.02511224,1825,63.8959875954,2096,43.0111756792,3921
NV,2020,1,15,26.64907543,1709,34.2328994083,1521,30.2202817058,3230
NV,2020,1,16,32.71429709,2120,52.4429873551,1898,42.0336236513,4018
NV,2020,1,17,30.16196282,2359,61.7078230088,2260,45.5968283811,4619
NV,2020,1,18,27.47978819,2408,46.431673932,2294,36.7259868059,4702
NV,2020,1,19,37.217008,2286,51.0492911074,2384,44.2782848582,4670
NV,2020,1,20,31.58873384,2251,61.1487901701,2116,45.9118570813,4367
NV,2020,1,21,23.16008633,2316,57.5308927039,2330,40.3972750625,4646
NV,2020,1,22,26.62764903,2331,55.3213824057,2228,40.6503816383,4559
NV,2020,1,23,31.32683016,2385,43.9858306636,2185,37.3793282126,4570
NV,2020,1,24,28.796894,2405,48.4961412078,2252,38.32292035,4657
NV,2020,1,25,25.03561105,2520,50.1967120954,2348,37.1716556791,4868
NV,2020,1,26,35.41891454,2460,63.2283001475,2712,50.0010981764,5172
NV,2020,1,27,28.02603092,2134,70.6441788046,1991,48.596390299,4125
NV,2020,1,28,22.9714782,2158,71.3656605641,2021,46.3753170509,4179
NV,2020,1,29,25.8670393,2192,61.4789501953,2048,43.0682641853,4240
NV,2020,1,30,27.28609281,2219,68.0344704127,2011,46.6584302471,4230
NV,2020,1,31,31.92288389,2299,50.346380662,2296,41.1286180768,4595
NV,2020,2,1,30.6311923,2449,60.2838002711,2213,44.7069583747,4662
NV,2020,2,2,20.73595764,1608,44.4840673981,2552,35.3045095878,4160
NV,2020,2,3,40.41859741,1319,31.2120963652,1183,36.0655635427,2502
NV,2020,2,4,23.54102839,1828,47.2153108027,1657,34.7973514769,3485
NV,2020,2,5,24.05371742,2074,48.3340047393,2110,36.2983173827,4184
NV,2020,2,6,30.37745424,1037,48.4023052797,1913,42.0661118803,2950
NV,2020,2,7,16.1719088,1163,17.8378371162,749,16.824513564,1912
NV,2020,2,8,26.4156125,2245,48.7755671982,2195,37.4696892033,4440
NV,2020,2,9,36.41894418,2046,49.1738171065,2198,43.0247902432,4244
NV,2020,2,10,24.40310097,1980,60.4610798122,1917,42.1406286684,3897
NV,2020,2,11,21.83341229,1940,54.7140305344,1965,38.3789730711,3905
NV,2020,2,12,30.33003864,2069,51.3342840909,1760,39.9846408843,3829
NV,2020,2,13,28.09880046,2426,60.8828731511,2231,43.804462082,4657
NV,2020,2,14,28.73610538,2370,55.1983083512,2335,41.8687820936,4705
NV,2020,2,15,23.00344411,2288,44.0377639752,2254,33.4418758529,4542
NV,2020,2,16,32.4167891,2233,53.5519479312,2151,42.7867084992,4384
NV,2020,2,17,28.51129216,2221,63.4614227642,2214,45.9587756229,4435
NV,2020,2,18,22.62439372,2342,46.5788138772,2133,34.0422212497,4475
NV,2020,2,19,23.97019026,2418,52.0330785473,2368,37.8550459776,4786
NV,2020,2,20,29.33697472,2532,58.7578253275,2290,43.3091331379,4822
NV,2020,2,21,29.91649983,2677,60.0085558252,2472,44.3634919489,5149
NV,2020,2,22,29.76736599,2726,54.1306336634,3535,43.5230202346,6261
NV,2020,2,23,40.06617976,2390,88.1326996198,2630,65.2484401646,5020
NV,2020,2,24,28.87186797,2227,73.5359926807,2186,50.9964491206,4413
NV,2020,2,25,25.03845597,2202,71.0596034816,2068,47.3269180435,4270
NV,2020,2,26,25.73330119,2278,44.4222976135,2137,34.7793680885,4415
NV,2020,2,27,28.78841245,2211,60.6492154132,2154,44.5107880703,4365
NV,2020,2,28,29.8527713,2284,57.4697786152,2123,43.1568118106,4407
NV,2020,2,29,26.19682331,2169,38.4148740266,2183,32.3255008638,4352
NV,2020,3,1,28.7089542,2161,52.8304552129,2043,40.4311774563,4204
NV,2020,3,2,25.69210942,2119,67.6781655373,2066,46.4192759524,4185
NV,2020,3,3,24.8063987,2127,64.7003215926,1959,43.9332207623,4086
NV,2020,3,4,28.32830199,2232,44.1259728945,2066,35.9220637603,4298
NV,2020,3,5,30.41504181,2390,48.7781746765,2164,39.1409573838,4554
NV,2020,3,6,30.8623423,2361,58.8526126516,2308,44.698612159,4669
NV,2020,3,7,30.84195509,2271,52.7378019982,2202,41.6209970958,4473
NV,2020,3,8,36.45297577,2107,63.7855098133,2089,50.060617242,4196
NV,2020,3,9,26.35268469,2071,61.7977816206,2024,43.8718241741,4095
NV,2020,3,10,27.70757673,2282,52.0301171303,2049,39.2145924955,4331
NV,2020,3,11,22.77425873,2543,48.2170819113,2344,34.9776509004,4887
NV,2020,3,12,27.60816865,2621,54.7188,2575,41.0434796058,5196
NV,2020,3,13,24.5852988,2376,55.7505717863,2396,40.2332439122,4772
NV,2020,3,14,20.15014762,2303,45.232152872,2211,32.4355516103,4514
NV,2020,3,15,21.66732335,2350,45.1267448935,2301,33.2734572936,4651
NV,2020,3,16,19.2256027,2406,46.5397070228,2321,32.6370763901,4727
NV,2020,3,17,11.50661924,2461,43.0059690894,2394,27.0389454067,4855
NV,2020,3,18,11.87747341,2355,36.5016149329,2384,24.2648870818,4739
NV,2020,3,19,9.796255991,2297,41.3823740354,2203,25.2594155581,4500
NV,2020,3,20,9.929913788,2204,29.5434680574,2301,19.9478468344,4505
NV,2020,3,21,8.156446881,2108,36.9803286385,2130,22.643201988,4238
NV,2020,3,22,6.777768465,2021,23.0951719057,2036,14.9666354616,4057
NV,2020,3,23,7.483074387,2124,22.116032888,1946,14.4795700241,4070
NV,2020,3,24,6.418104448,2163,22.1672473532,2078,14.1348502525,4241
NV,2020,3,25,9.698474493,2196,28.948721038,2158,19.2395934742,4354
NV,2020,3,26,9.501310965,2273,29.9186214953,2140,19.4022954506,4413
NV,2020,3,27,8.305086883,2186,22.6643988816,2146,15.4184487364,4332
NV,2020,3,28,7.507305621,2071,26.7331432749,2052,17.0759252828,4123
NV,2020,3,29,7.478440991,2136,22.3401418787,2044,14.7457416165,4180
NV,2020,3,30,6.889057669,2133,31.1152810651,2028,18.6965032463,4161
NV,2020,3,31,7.717573374,2250,31.5629107312,2106,19.2461042451,4356
NV,2020,4,1,6.932483069,2219,25.8695597484,2226,16.4159324927,4445
NV,2020,4,2,8.06442276,2148,27.529527027,2072,17.6216967034,4220
NV,2020,4,3,7.966979264,2079,31.5216737388,2121,19.8620999738,4200
NV,2020,4,4,5.957403874,2003,23.0407106339,1956,14.3976534376,3959
NV,2020,4,5,7.193215931,1959,32.4376989356,1973,19.8603992901,3932
NV,2020,4,6,7.650609748,2050,24.0164776275,1922,15.5698439032,3972
NV,2020,4,7,7.051156325,2041,32.8040568862,2004,19.8098244893,4045
NV,2020,4,8,7.043799472,1945,32.7304447776,2001,20.0693892481,3946
NV,2020,4,9,7.833173288,1916,27.9343122886,1774,17.4969729051,3690
NV,2020,4,10,8.810957041,1933,25.4159948187,1930,17.1070282061,3863
NV,2020,4,11,6.572343912,1954,22.1751448879,1829,14.1159661655,3783
NV,2020,4,12,5.844827725,1916,21.0883103814,1888,13.4104679078,3804
NV,2020,4,13,6.100902017,1929,24.323184573,1815,14.934620724,3744
NV,2020,4,14,7.450829207,2002,25.1413329848,1913,16.0950012956,3915
NV,2020,4,15,8.997893187,2041,20.1328729839,1984,14.4865391291,4025
NV,2020,4,16,8.422000947,2044,25.3364180619,1971,16.7254420761,4015
NV,2020,4,17,6.010238697,1969,23.6366734075,1978,14.8435520634,3947
NV,2020,4,18,6.970069839,1861,22.0210520548,1825,14.4220618476,3686
NV,2020,4,19,8.416204051,1852,30.229059081,1828,19.2515026909,3680
NV,2020,4,20,7.367618562,1919,28.7013137033,1766,17.5915820951,3685
NV,2020,4,21,6.776925015,2013,24.8785069075,1882,15.5233119526,3895
NV,2020,4,22,8.895213823,2081,27.0204780488,2050,17.8898378034,4131
NV,2020,4,23,8.145074043,2093,38.5838567901,2025,23.1131495804,4118
NV,2020,4,24,8.855546736,1884,33.5737468354,1975,21.5060896737,3859
NV,2020,4,25,7.337815791,1694,28.1678699552,1784,18.022351912,3478
NV,2020,4,26,7.271034506,1682,22.8586758538,1669,15.0346195282,3351
NV,2020,4,27,7.091027239,1762,26.2402852253,1753,16.6411408236,3515
NV,2020,4,28,9.180743868,1761,20.3669351908,1651,14.5935228463,3412
NV,2020,4,29,8.505176911,1837,26.8096630497,1751,17.4380518354,3588
NV,2020,4,30,10.06148719,1876,31.2447672462,1783,20.3839218279,3659
NV,2020,5,1,10.30545555,1822,33.4350857143,1925,22.1881718741,3747
NV,2020,5,2,9.104326171,1625,23.9045966229,1599,16.4447828871,3224
NV,2020,5,3,8.38345244,1651,24.9844810127,1580,16.5015660719,3231
NV,2020,5,4,8.458513912,1790,26.7489768786,1730,17.4478607678,3520
NV,2020,5,5,6.356463952,1776,36.5515588915,1732,21.2646465162,3508
NV,2020,5,6,9.443142185,1814,33.3839305302,1641,20.8141504844,3455
NV,2020,5,7,10.29577708,1821,33.9573153978,1747,21.8811771476,3568
NV,2020,5,8,11.98828171,1746,23.0209378596,1738,17.4919431302,3484
NV,2020,5,9,11.8716875,1760,24.578339307,1674,18.0659027373,3434
NV,2020,5,10,11.7473448,1691,27.4694721056,1667,19.5522245553,3358
NV,2020,5,11,8.930842337,1757,26.8931504316,1622,17.5531754916,3379
NV,2020,5,12,8.187157554,1745,22.8688654971,1710,15.4536468688,3455
NV,2020,5,13,6.566598512,1614,34.0123149793,1689,20.6010566147,3303
NV,2020,5,14,9.208406085,1650,23.4072324967,1514,16.0026612011,3164
NV,2020,5,15,11.41593947,1751,45.5450938338,1865,29.018503875,3616
NV,2020,5,16,13.79412254,1681,36.2354034668,1673,24.9879994006,3354
NV,2020,5,17,10.93538747,1652,30.1270229956,1609,20.4046734439,3261
NV,2020,5,18,9.733233298,1732,32.7142973761,1715,21.1670960465,3447
NV,2020,5,19,10.63100739,1757,27.1635095267,1627,18.579701532,3384
NV,2020,5,20,10.95706011,1813,30.8178142695,1766,20.7570298909,3579
NV,2020,5,21,13.6853724,1759,30.4798120729,1756,22.0754253347,3515
NV,2020,5,22,12.77812655,1628,38.5971902269,1719,26.0386495439,3347
NV,2020,5,23,12.62135759,1591,32.9083759591,1564,22.6780601983,3155
NV,2020,5,24,12.28682636,1607,33.0923495519,1562,22.5418680847,3169
NV,2020,5,25,16.53047844,1693,29.3615909091,1584,22.7326396091,3277
NV,2020,5,26,12.31572308,1791,36.1927111636,1693,23.9184041436,3484
NV,2020,5,27,10.23664491,1839,29.5549168101,1743,19.6369095448,3582
NV,2020,5,28,13.66919892,1860,24.035395845,1781,18.7398379542,3641
NV,2020,5,29,13.23640642,1806,31.0442408098,1877,22.3119712176,3683
NV,2020,5,30,10.4282307,1803,30.070418552,1768,20.1530663546,3571
NV,2020,5,31,16.52669632,1798,33.7859237057,1835,25.2441976282,3633
NV,2020,6,1,11.73560002,1850,36.4343413831,1822,23.990803387,3672
NV,2020,6,2,8.721836954,1840,25.5098332437,1859,17.1589510666,3699
NV,2020,6,3,8.823422503,1756,38.9905980449,1739,23.833642322,3495
NV,2020,6,4,14.09598818,1705,32.3671728045,1765,23.3895446245,3470
NV,2020,6,5,13.60733721,1705,28.9296700059,1697,21.2504879315,3402
NV,2020,6,6,12.77814288,1610,35.8538949939,1638,24.4154833857,3248
NV,2020,6,7,18.72910193,1559,45.4312523134,1621,32.3404811034,3180
NV,2020,6,8,15.31634006,1582,38.5797647059,1530,26.7536921513,3112
NV,2020,6,9,11.22265651,1645,36.7312523364,1605,23.8199784489,3250
NV,2020,6,10,12.6207611,1695,28.5160518385,1659,20.4831007944,3354
NV,2020,6,11,16.51069177,1778,36.7317977528,1691,26.367679437,3469
NV,2020,6,12,18.65790045,1648,34.1697620464,1681,26.4907149119,3329
NV,2020,6,13,16.35639875,1680,36.9110510141,1627,26.469014182,3307
NV,2020,6,14,19.82960061,1728,32.7547690462,1667,26.1760677037,3395
NV,2020,6,15,16.82479815,1759,40.996649061,1704,28.7187727248,3463
NV,2020,6,16,17.19515621,1761,36.9057934656,1714,26.9171798808,3475
NV,2020,6,17,15.72352225,1729,36.1026094781,1667,25.7270376826,3396
NV,2020,6,18,18.35072031,1777,28.4135622817,1718,23.2972045754,3495
NV,2020,6,19,19.77346171,1739,43.2342632499,1717,31.4291897898,3456
NV,2020,6,20,19.23773159,1706,37.6419964871,1708,28.4452548601,3414
NV,2020,6,21,24.30294576,1677,51.1645470588,1700,37.8252206217,3377
NV,2020,6,22,18.86343866,1678,40.1435601764,1587,29.2069464231,3265
NV,2020,6,23,15.41637038,1755,43.0026627566,1705,29.0101936465,3460
NV,2020,6,24,15.84744373,1776,31.8267524868,1709,23.683494997,3485
NV,2020,6,25,17.42655533,1768,43.9487786697,1744,30.5970443689,3512
NV,2020,6,26,17.99828485,1720,47.2957033549,1699,32.5570195794,3419
NV,2020,6,27,18.02566852,1780,40.0232318501,1708,28.797411114,3488
NV,2020,6,28,20.98397917,1822,38.3585888889,1800,29.6185174069,3622
NV,2020,6,29,16.28465332,1745,44.484059754,1707,30.2291454355,3452
NV,2020,6,30,13.90903978,1635,37.4306521739,1702,25.9059784358,3337
NV,2020,7,1,19.58354378,1775,45.9599317406,1758,32.7082791422,3533
NV,2020,7,2,22.00902672,1798,46.0525279248,1701,33.6975078716,3499
NV,2020,7,3,22.23709917,1896,41.8439723757,1810,31.8130410217,3706
NV,2020,7,4,17.43638886,1872,39.2606713212,1862,28.3193063594,3734
NV,2020,7,5,30.31029478,1831,49.4714659978,1794,39.7930923427,3625
NV,2020,7,6,19.58517993,1778,53.6724356103,1786,36.6670650717,3564
NV,2020,7,7,16.66679654,1770,48.8511995386,1734,32.593667202,3504
NV,2020,7,8,20.05956325,1809,38.3540784314,1785,29.1457373175,3594
NV,2020,7,9,22.61683234,1831,35.7846101309,1757,29.0649331144,3588
NV,2020,7,10,21.15261971,1817,42.1243196544,1852,31.738498232,3669
NV,2020,7,11,15.60585193,1837,41.4212520961,1789,28.3426833964,3626
NV,2020,7,12,24.67045677,1795,47.6231959911,1796,36.1500222507,3591
NV,2020,7,13,21.74333702,1804,48.8946511628,1720,34.9953972713,3524
NV,2020,7,14,16.63754498,1776,41.4940458937,1656,28.6312412251,3432
NV,2020,7,15,15.84949431,1760,46.3938257357,1733,31.0036100732,3493
NV,2020,7,16,18.58995971,1735,45.164349642,1676,31.6473263257,3411
NV,2020,7,17,20.48627638,1751,54.9329525483,1707,37.4904626782,3458
NV,2020,7,18,18.00109077,1751,31.3700177515,1690,24.5670560704,3441
NV,2020,7,19,26.62991877,1725,48.8554898447,1674,37.5759634829,3399
NV,2020,7,20,18.64944091,1735,50.8456147541,1708,34.6212866625,3443
NV,2020,7,21,18.55873579,1764,49.0378115683,1677,33.4129671414,3441
NV,2020,7,22,15.86132598,1810,41.8446765579,1685,28.3883490769,3495
NV,2020,7,23,17.38820542,1850,38.6791959799,1791,27.8611974806,3641
NV,2020,7,24,23.33898128,1767,45.093239046,1803,34.3257954963,3570
NV,2020,7,25,19.735721,1678,34.6671840094,1701,27.2522698544,3379
NV,2020,7,26,23.51068863,1699,51.3856973294,1685,37.3905319097,3384
NV,2020,7,27,22.55062431,1794,49.2888669378,1721,35.6420938868,3515
NV,2020,7,28,15.29198766,1776,49.9341241945,1707,32.2699167626,3483
NV,2020,7,29,20.05930178,1733,44.225188457,1698,32.018985714,3431
NV,2020,7,30,20.09778851,1768,53.9849529412,1700,36.7091436233,3468
NV,2020,7,31,24.35590801,1718,47.8549516771,1759,36.2439775557,3477
NY,2020,1,1,18.5046785,9565,34.2616032959,10073,26.5869426547,19638
NY,2020,1,2,17.12683643,9388,28.1701952278,9220,22.5986640372,18608
NY,2020,1,3,15.19364075,9292,24.022924638,9461,19.6480669679,18753
NY,2020,1,4,13.53986069,9406,19.3457951567,9539,16.4632076881,18945
NY,2020,1,5,15.73583882,9156,20.8251867309,9345,18.3065083096,18501
NY,2020,1,6,13.10496501,9424,24.8145454545,9163,18.877541844,18587
NY,2020,1,7,11.70757194,9662,20.4651254857,9523,16.0546234081,19185
NY,2020,1,8,12.97903829,9587,24.970668752,9271,18.8743827599,18858
NY,2020,1,9,15.3688765,9577,25.5267813423,9476,20.4209053819,19053
NY,2020,1,10,15.81494813,8969,26.8929806562,9357,21.4712370282,18326
NY,2020,1,11,13.29504978,9038,18.3174598624,8720,15.7612856128,17758
NY,2020,1,12,16.12742528,9368,20.8639381735,9187,18.4725798988,18555
NY,2020,1,13,12.63219578,9869,23.0731777232,9768,17.8258359298,19637
NY,2020,1,14,11.26294633,8166,23.4745700346,9838,17.935794253,18004
NY,2020,1,15,16.85361391,7687,17.9106570561,6590,17.3415255394,14277
NY,2020,1,16,16.59316693,9495,21.0938907338,9335,18.8244073287,18830
NY,2020,1,17,17.10185265,9203,26.4873577447,9613,21.8968601157,18816
NY,2020,1,18,12.76106755,9021,20.0918564329,9055,16.4333564045,18076
NY,2020,1,19,16.00906376,8929,20.8634925607,8939,18.4376365745,17868
NY,2020,1,20,17.18647881,9335,29.0727065006,8753,22.938366856,18088
NY,2020,1,21,13.65307789,9812,25.1080620884,9567,19.308159877,19379
NY,2020,1,22,13.62681213,9853,25.4028190124,9741,19.4811595344,19594
NY,2020,1,23,14.69345577,9636,26.2168821809,9574,20.4365731286,19210
NY,2020,1,24,14.55115245,9059,27.5150421963,9361,21.1393702521,18420
NY,2020,1,25,14.61025618,9407,21.1035224154,8744,17.7382998119,18151
NY,2020,1,26,14.86870085,9560,23.3703313196,10594,19.3376039558,20154
NY,2020,1,27,12.41214154,9255,22.4767746983,8948,17.3595863293,18203
NY,2020,1,28,11.17158558,9662,22.5340280801,9188,16.7099474734,18850
NY,2020,1,29,12.39303465,9787,25.1503801047,9550,18.6935284749,19337
NY,2020,1,30,13.46721436,10030,24.6742181628,9580,18.9421300373,19610
NY,2020,1,31,15.10116225,9516,25.3349166005,10072,20.3632805785,19588
NY,2020,2,1,15.1169859,9857,28.3606709539,9330,21.5569494979,19187
NY,2020,2,2,11.08197475,6963,21.768569716,10844,17.589833222,17807
NY,2020,2,3,19.41766264,6041,15.4183065721,5356,17.5381723268,11397
NY,2020,2,4,11.84999444,9004,15.7077277771,8111,13.6782196867,17115
NY,2020,2,5,11.94608242,9802,20.2242122155,10282,16.1840694026,20084
NY,2020,2,6,21.8380445,4725,23.6627570248,9075,23.0379913234,13800
NY,2020,2,7,9.762678286,5160,8.12731767956,3620,9.08841799041,8780
NY,2020,2,8,13.43440732,9491,21.187692472,9365,17.2851453052,18856
NY,2020,2,9,19.24644807,8995,26.786238812,9832,23.1839432937,18827
NY,2020,2,10,13.77767745,9115,21.8551739771,8823,17.7506817904,17938
NY,2020,2,11,13.55688787,8936,22.5352822366,9407,18.1613558309,18343
NY,2020,2,12,14.76083008,9144,19.5461358915,8183,17.0207802996,17327
NY,2020,2,13,15.3555543,10374,24.7343206549,10017,19.9628370511,20391
NY,2020,2,14,14.72815443,9195,23.2620432788,10028,19.1800005194,19223
NY,2020,2,15,13.31609484,8604,19.9131225065,8522,16.5988152519,17126
NY,2020,2,16,15.53227485,8607,20.3965623161,8497,17.9487768729,17104
NY,2020,2,17,15.27242771,8984,23.8232779611,8789,19.5009441595,17773
NY,2020,2,18,13.58547639,9886,22.9788375918,9119,18.0926092918,19005
NY,2020,2,19,13.46332131,9969,20.8875434677,10295,17.2351515071,20264
NY,2020,2,20,16.83292635,9312,24.9855455035,9285,20.9033177486,18597
NY,2020,2,21,17.69138538,8864,26.5679028698,9060,22.1781767467,17924
NY,2020,2,22,14.71788706,8609,19.3872033819,10645,17.2994219227,19254
NY,2020,2,23,18.30787965,8909,24.204297631,8991,21.2695944023,17900
NY,2020,2,24,14.81448844,9803,24.3397150176,9369,19.4692895982,19172
NY,2020,2,25,13.35205673,10011,23.5383485594,9961,18.4324519289,19972
NY,2020,2,26,14.10295242,9914,23.5047309948,9721,18.7576348506,19635
NY,2020,2,27,16.26349328,9919,24.5460405571,9764,20.3721551514,19683
NY,2020,2,28,17.3564524,9257,28.0061512884,9624,22.7848037639,18881
NY,2020,2,29,15.76917159,8655,24.4374160812,8967,20.1800300824,17622
NY,2020,3,1,18.36289892,8962,28.7346395201,8669,23.462588062,17631
NY,2020,3,2,13.83717337,9658,21.3189658147,9273,17.5019909359,18931
NY,2020,3,3,12.41554825,9996,22.7962303937,9627,17.5082877392,19623
NY,2020,3,4,14.07515271,10051,22.4821299786,9817,18.2291337773,19868
NY,2020,3,5,14.19405223,9955,24.8408730873,9999,19.5292011602,19954
NY,2020,3,6,14.33258627,9187,23.1769866832,9687,18.8719370596,18874
NY,2020,3,7,15.1813049,8828,17.0274624374,8985,16.112519489,17813
NY,2020,3,8,16.7528511,8972,22.0533648633,8669,19.3575874423,17641
NY,2020,3,9,12.0458419,9740,21.2174405909,9342,16.5359936121,19082
NY,2020,3,10,10.52885699,10551,18.1967135485,9883,14.237451801,20434
NY,2020,3,11,11.16499914,11806,22.5773919295,11127,16.7022465376,22933
NY,2020,3,12,12.00247893,11614,21.046513676,11809,16.5621427782,23423
NY,2020,3,13,12.44804313,10399,21.18707011,10997,16.9396808052,21396
NY,2020,3,14,9.597576856,10375,17.3325240434,9774,13.3496922865,20149
NY,2020,3,15,10.15913719,10686,16.7907670401,10534,13.4512007546,21220
NY,2020,3,16,8.331673313,11271,14.2096660808,10811,11.2094461512,22082
NY,2020,3,17,7.426391108,11322,15.5455689103,11232,11.4697805323,22554
NY,2020,3,18,6.997864564,11150,14.0276758901,10589,10.4220640273,21739
NY,2020,3,19,5.467698304,11422,15.3351669017,10635,10.2253955673,22057
NY,2020,3,20,5.874664537,10940,12.9524330357,11200,9.45510749931,22140
NY,2020,3,21,5.456747035,10492,9.84187070151,10178,7.61600144612,20670
NY,2020,3,22,4.236878824,10275,9.56163976128,10221,6.89224482419,20496
NY,2020,3,23,3.929550405,10565,10.8530168882,10007,7.29738674066,20572
NY,2020,3,24,3.926021217,10835,10.0578248343,10413,6.93103209178,21248
NY,2020,3,25,4.728264533,10902,11.6176026995,10224,8.06238331623,21126
NY,2020,3,26,4.282382965,10936,11.5366393443,10492,7.83435505438,21428
NY,2020,3,27,4.436452376,10376,13.779135104,10429,9.11969381655,20805
NY,2020,3,28,4.479573329,10125,10.5028840385,9667,7.42153698242,19792
NY,2020,3,29,4.128435198,10193,9.948908632,9905,6.99696885129,20098
NY,2020,3,30,4.37653411,10410,11.2831332064,9977,7.7564889432,20387
NY,2020,3,31,4.519883136,10609,13.7916284473,9899,8.9952589326,20508
NY,2020,4,1,4.20368712,10496,11.0280825902,10316,7.58637324676,20812
NY,2020,4,2,4.341701625,10349,11.7267588199,9694,7.91355935325,20043
NY,2020,4,3,3.481544657,9931,11.7634573393,9892,7.61435403262,19823
NY,2020,4,4,3.533599116,9669,10.4377932575,9403,6.93754927918,19072
NY,2020,4,5,3.878957059,9387,11.6120896813,9255,7.71814504414,18642
NY,2020,4,6,3.610711629,9738,12.1784929855,9124,7.75515214946,18862
NY,2020,4,7,3.728427774,10113,12.0407783613,9520,7.75906891858,19633
NY,2020,4,8,4.539321065,9235,11.3576801459,9867,8.06129515419,19102
NY,2020,4,9,4.938851616,8943,10.4054175302,8203,7.5541694857,17146
NY,2020,4,10,3.998870906,9140,12.6891238407,9165,8.34993171706,18305
NY,2020,4,11,2.684066957,8933,11.3024793003,8575,6.90515936297,17508
NY,2020,4,12,3.277756005,8984,10.9670304278,8742,7.06990522108,17726
NY,2020,4,13,4.056960281,9422,10.3526489846,9011,7.13461724991,18433
NY,2020,4,14,3.843409108,9545,10.4558419016,9045,7.06070091102,18590
NY,2020,4,15,4.091947133,9722,12.952503251,9228,8.40673403837,18950
NY,2020,4,16,4.2372841,9669,11.9398453442,9311,8.01592202123,18980
NY,2020,4,17,4.640446027,9192,11.1105252439,9329,7.89941525189,18521
NY,2020,4,18,3.332453719,8860,10.8788450608,8797,7.09218666536,17657
NY,2020,4,19,3.948443736,8771,11.1858018374,8599,7.53129015593,17370
NY,2020,4,20,4.860087338,9044,12.1855102516,8584,8.42722089204,17628
NY,2020,4,21,4.656465381,9257,11.8668083887,8726,8.15518378646,17983
NY,2020,4,22,4.845880683,9385,14.4244965986,8820,9.48655040978,18205
NY,2020,4,23,4.41291029,9542,14.8600713359,9252,9.55588858078,18794
NY,2020,4,24,4.469124734,8820,8.72530891197,9145,6.6357155666,17965
NY,2020,4,25,3.463941944,8369,12.4452616708,8140,7.89231086858,16509
NY,2020,4,26,4.463864279,8237,8.11601832621,8185,6.28415905895,16422
NY,2020,4,27,4.795944376,8630,10.6069337979,8036,7.59788311322,16666
NY,2020,4,28,4.264902296,8853,12.9719995179,8297,8.47730962254,17150
NY,2020,4,29,5.029217191,8942,10.7852204586,8505,7.83513269456,17447
NY,2020,4,30,5.869538811,9150,9.92537000579,8635,7.83873208438,17785
NY,2020,5,1,4.677037932,8430,13.485643319,9280,9.29272725956,17710
NY,2020,5,2,4.17940553,8125,12.0181375648,7909,8.04597230456,16034
NY,2020,5,3,4.959583423,8306,11.2237631092,8105,8.05331179766,16411
NY,2020,5,4,5.379268902,8795,11.5828566208,8209,8.37416725436,17004
NY,2020,5,5,5.145962709,8798,13.3750697729,8456,9.17895965653,17254
NY,2020,5,6,4.822610895,8813,13.7764845804,8366,9.18305721041,17179
NY,2020,5,7,4.431518285,8918,13.8871041789,8495,9.04446276148,17413
NY,2020,5,8,4.758320851,8415,12.3839823625,8618,8.61659308173,17033
NY,2020,5,9,5.870950105,8357,10.0449889272,8128,7.92897786033,16485
NY,2020,5,10,5.78637861,8077,14.5960230403,7986,10.1662466559,16063
NY,2020,5,11,4.796219872,8214,11.4036091661,7855,8.02610616893,16069
NY,2020,5,12,4.50514732,8418,11.3328911399,8194,7.87298580182,16612
NY,2020,5,13,4.210375767,7824,10.4601388206,8140,7.39711287904,15964
NY,2020,5,14,5.126043508,7997,10.3700688326,7264,7.62211846756,15261
NY,2020,5,15,6.034296497,8209,15.2453432589,8463,10.7099856012,16672
NY,2020,5,16,6.270453863,7932,13.3702130087,7887,9.81023516286,15819
NY,2020,5,17,6.009920557,7928,11.4143422766,7678,8.66884340484,15606
NY,2020,5,18,5.766941541,8282,14.354354921,7844,9.9440264072,16126
NY,2020,5,19,5.556958341,8354,12.9893783282,8075,9.21005904076,16429
NY,2020,5,20,6.091257931,8363,12.933123587,7962,9.42816049476,16325
NY,2020,5,21,6.093708659,8464,16.1647998004,8017,10.9926794545,16481
NY,2020,5,22,5.333588653,7989,12.3342294686,8280,8.89651851674,16269
NY,2020,5,23,4.997205995,7670,11.572609432,7676,8.2861931436,15346
NY,2020,5,24,6.005023286,7517,11.4637780465,7443,8.72089973535,14960
NY,2020,5,25,6.134661613,7802,10.3460098261,7531,8.20311940942,15333
NY,2020,5,26,4.829090126,8210,10.9242133838,7920,7.82185988434,16130
NY,2020,5,27,4.537982141,8504,14.3185742331,8150,9.32432929789,16654
NY,2020,5,28,5.782306216,8876,14.7426621897,8339,10.1227307565,17215
NY,2020,5,29,6.536039624,8623,14.0455393394,9113,10.3945235497,17736
NY,2020,5,30,4.963862188,8446,12.6206258677,8644,8.836598598,17090
NY,2020,5,31,5.732646714,8690,14.8489295282,8585,10.2630830648,17275
NY,2020,6,1,5.309071634,9242,16.2119516389,9305,10.7790289557,18547
NY,2020,6,2,3.839971091,8994,11.5878396267,9216,7.7611328936,18210
NY,2020,6,3,5.317983418,8683,13.2447963701,9036,9.36034934356,17719
NY,2020,6,4,6.46924726,8622,12.7514176153,8345,9.55905168125,16967
NY,2020,6,5,5.881077549,8046,11.305124641,8705,8.69979463669,16751
NY,2020,6,6,5.14360394,7489,12.8907170465,7503,9.02077774191,14992
NY,2020,6,7,5.990730471,7228,16.2391766794,7324,11.1487582356,14552
NY,2020,6,8,6.353569261,7475,13.3736364918,7092,9.77131600371,14567
NY,2020,6,9,4.633492976,7767,11.3208071749,7582,7.93684930253,15349
NY,2020,6,10,6.66852605,7965,13.3666518731,7661,9.95243376349,15626
NY,2020,6,11,5.666638559,7827,15.4436726168,7899,10.5775371996,15726
NY,2020,6,12,7.43135794,7261,14.5965315436,7450,11.0599721299,14711
NY,2020,6,13,6.780765491,7015,12.6721314336,6878,9.69740084354,13893
NY,2020,6,14,7.301852459,7266,13.9932742003,7159,10.6227459249,14425
NY,2020,6,15,6.102516282,7666,16.6871680935,7359,11.2867061443,15025
NY,2020,6,16,6.676662463,7919,15.2809508841,7635,10.9002539568,15554
NY,2020,6,17,6.083737972,8015,14.4355779674,7734,10.1851495235,15749
NY,2020,6,18,7.434910185,8016,16.6269745666,7903,11.9983177362,15919
NY,2020,6,19,7.846529313,7474,21.1913657495,7959,14.7286360452,15433
NY,2020,6,20,7.918537141,7458,14.7584397163,7332,11.309352941,14790
NY,2020,6,21,8.089930044,7580,18.8846186154,7381,13.4154829045,14961
NY,2020,6,22,6.100830444,7984,14.2437026777,7581,10.0668512859,15565
NY,2020,6,23,5.85469729,7911,12.4110047488,8002,9.15159745247,15913
NY,2020,6,24,7.196471073,7651,12.8804026578,7525,10.0148412085,15176
NY,2020,6,25,7.450380617,7751,15.1888881447,7465,11.2469078708,15216
NY,2020,6,26,8.094583071,7327,14.0403116676,7508,11.1037189189,14835
NY,2020,6,27,6.931924083,7271,18.0704428148,7091,12.4313835126,14362
NY,2020,6,28,7.55865428,7483,17.2495081081,7400,12.3770590591,14883
NY,2020,6,29,7.28841648,7799,15.1383245729,7610,11.1652287707,15409
NY,2020,6,30,5.365613083,7593,14.7461688729,7781,10.1132457486,15374
NY,2020,7,1,7.570322667,7562,17.2998065591,7806,12.5123028376,15368
NY,2020,7,2,10.41132186,7550,20.5068162336,7466,15.4308317823,15016
NY,2020,7,3,8.78078227,7312,19.9622596853,7563,14.4658588207,14875
NY,2020,7,4,8.574924929,6928,19.097730904,7135,13.9137730149,14063
NY,2020,7,5,8.977129683,7055,19.7478982498,6742,14.2403406475,13797
NY,2020,7,6,8.181920952,7590,16.867935019,7356,12.4569322913,14946
NY,2020,7,7,7.49946189,7656,13.7528298073,7421,10.577411304,15077
NY,2020,7,8,7.067154312,7854,15.9641598845,7618,11.4478024797,15472
NY,2020,7,9,8.630438251,7941,17.3859190796,7736,12.9509332239,15677
NY,2020,7,10,6.978561725,7509,17.5572315158,7831,12.3789243802,15340
NY,2020,7,11,7.79577925,7103,14.3320227367,7213,11.0890122948,14316
NY,2020,7,12,7.922256041,7163,14.7949605282,6967,11.310941969,14130
NY,2020,7,13,7.649343863,7666,17.1376115557,7373,12.3010492755,15039
NY,2020,7,14,6.806568138,7748,14.8993667021,7532,10.7957670113,15280
NY,2020,7,15,6.873983528,7762,16.240581304,7638,11.5195727366,15400
NY,2020,7,16,7.720757046,7701,18.3110908848,7471,12.9356518594,15172
NY,2020,7,17,8.96159962,7158,20.2912561741,7491,14.7552003604,14649
NY,2020,7,18,7.856557787,6827,19.8844286337,6887,13.896804726,13714
NY,2020,7,19,7.799979078,7172,18.1828199913,6883,12.8846531446,14055
NY,2020,7,20,7.162429531,7697,16.4675355514,7454,11.7403623589,15151
NY,2020,7,21,6.478757522,7847,13.6292536116,7476,9.96744177218,15323
NY,2020,7,22,6.141635826,8167,15.5585489845,7829,10.7506013873,15996
NY,2020,7,23,7.97099988,8171,14.6980681259,8132,11.3264877642,16303
NY,2020,7,24,7.693454833,7297,14.927945188,7845,11.441610746,15142
NY,2020,7,25,7.348401994,6965,18.4403644356,7052,12.9288057279,14017
NY,2020,7,26,8.482873783,7123,16.1964271226,6902,12.2788770022,14025
NY,2020,7,27,7.972670776,7627,15.6512894809,7282,11.7231370319,14909
NY,2020,7,28,7.568119008,7932,15.9958291787,7622,11.6979895828,15554
NY,2020,7,29,7.174982899,7895,14.3944447284,7825,10.7686399483,15720
NY,2020,7,30,8.018377042,7739,18.8442980981,7729,13.4278381128,15468
NY,2020,7,31,8.783691345,7030,16.677974734,7520,12.8637608354,14550
OH,2020,1,1,15.83409477,4474,24.6074130203,4685,20.3218113332,9159
OH,2020,1,2,14.27143346,4374,17.4051895677,4141,15.7954362835,8515
OH,2020,1,3,13.06775899,4498,19.928494576,4517,16.5053566209,9015
OH,2020,1,4,12.42232344,4532,17.0394356757,4625,14.7543256339,9157
OH,2020,1,5,12.20402795,4295,17.7895360941,4419,15.036522842,8714
OH,2020,1,6,10.83098989,4455,15.59820693,4127,13.1234980144,8582
OH,2020,1,7,8.282285075,4560,17.7460745369,4481,12.9728326448,9041
OH,2020,1,8,10.37794552,4517,19.2596740129,4356,14.7382305775,8873
OH,2020,1,9,12.33807539,4697,18.2539973527,4533,15.2434788848,9230
OH,2020,1,10,11.53378153,4485,21.098071066,4728,16.4420590646,9213
OH,2020,1,11,12.10872162,4498,16.0562227171,4490,14.0807153813,8988
OH,2020,1,12,14.13682256,4639,18.3636624063,4538,16.2269826584,9177
OH,2020,1,13,8.805034547,4773,17.2174932164,4791,13.0191802481,9564
OH,2020,1,14,9.472681368,3722,14.577725423,4669,12.3132785189,8391
OH,2020,1,15,11.67227565,3533,13.2032132031,2969,12.37134572,6502
OH,2020,1,16,11.8110967,4477,17.6650321248,4358,14.6986406255,8835
OH,2020,1,17,13.99122646,4468,20.8243386014,4619,17.4645559396,9087
OH,2020,1,18,11.34750165,4479,16.5315831254,4409,13.9191280255,8888
OH,2020,1,19,12.56694976,4321,16.3240307275,4426,14.4680404611,8747
OH,2020,1,20,11.59731914,4312,16.4922597779,4142,13.9955737085,8454
OH,2020,1,21,9.065753557,4432,16.6138011152,4304,12.7844802844,8736
OH,2020,1,22,10.45162336,4540,15.1331649909,4376,12.7493382744,8916
OH,2020,1,23,11.0709437,4493,18.3684034569,4397,14.6802722209,8890
OH,2020,1,24,12.38521078,4247,18.6603113553,4368,15.5668288082,8615
OH,2020,1,25,11.34858697,4409,18.6244875212,4127,14.8663519155,8536
OH,2020,1,26,11.11643476,4572,17.5493936992,5047,14.4917485937,9619
OH,2020,1,27,10.96203586,4347,15.2573599217,4087,13.0434906193,8434
OH,2020,1,28,10.19829513,4499,17.5979186658,4377,13.8472532436,8876
OH,2020,1,29,11.02663517,4553,19.4667511779,4457,15.2017291819,9010
OH,2020,1,30,11.84224688,4722,18.8395361991,4420,15.2253160979,9142
OH,2020,1,31,12.8677556,4509,18.7680147059,4760,15.8977732226,9269
OH,2020,2,1,14.69750159,4711,20.9971801863,4401,17.7401799814,9112
OH,2020,2,2,9.703536832,3096,14.8653872699,5216,12.9427346044,8312
OH,2020,2,3,12.91295262,2635,11.4373622929,2233,12.2360846659,4868
OH,2020,2,4,7.725028923,4146,11.4802571988,3577,9.4643079004,7723
OH,2020,2,5,10.01131418,4459,16.16658125,4800,13.2022939765,9259
OH,2020,2,6,12.74157432,2147,14.086392186,4044,13.6200177782,6191
OH,2020,2,7,8.668745371,2439,6.2360488677,1678,7.67723098369,4117
OH,2020,2,8,12.08388523,4270,15.8524762955,4535,14.0248915312,8805
OH,2020,2,9,14.56756451,3991,15.1851303936,4218,14.8848860957,8209
OH,2020,2,10,10.51356051,4064,14.7837496787,3891,12.6022224906,7955
OH,2020,2,11,9.231470454,4060,17.03608,4125,13.164764819,8185
OH,2020,2,12,12.40636408,4186,15.5972907725,3728,13.9094945715,7914
OH,2020,2,13,15.02336066,4758,17.0244832185,4499,15.9959274085,9257
OH,2020,2,14,13.71208145,4420,18.37429213,4676,16.1087939764,9096
OH,2020,2,15,11.95083834,3972,16.256483705,4081,14.1328001846,8053
OH,2020,2,16,16.59945731,4146,19.7373726075,4023,18.144791285,8169
OH,2020,2,17,11.46182874,4320,15.6240353292,4359,13.5522836913,8679
OH,2020,2,18,9.042620177,4576,17.8273364706,4250,13.272740758,8826
OH,2020,2,19,11.45051838,4514,20.4945553381,4599,16.0147152384,9113
OH,2020,2,20,14.77981514,4382,17.8575017222,4355,16.313902935,8737
OH,2020,2,21,15.51030344,4251,20.9664121957,4231,18.2319252445,8482
OH,2020,2,22,14.99638736,4166,19.0632696942,5395,17.2912132352,9561
OH,2020,2,23,15.69373101,4090,17.6366060457,4069,16.6626681984,8159
OH,2020,2,24,10.65448217,4471,14.4381327014,4220,12.4916706687,8691
OH,2020,2,25,10.91287109,4507,17.9143642312,4585,14.4436504622,9092
OH,2020,2,26,10.81151276,4429,16.5443209592,4337,13.6478336772,8766
OH,2020,2,27,14.76343446,4516,16.7324029237,4378,15.7326433575,8894
OH,2020,2,28,15.92874541,4376,21.3799688127,4489,18.6890998211,8865
OH,2020,2,29,17.89826507,4098,20.7549323694,4288,19.3589602023,8386
OH,2020,3,1,15.6923572,4009,18.3078206097,3969,16.9935322154,7978
OH,2020,3,2,11.62493243,4217,17.0869319608,3983,14.2779987875,8200
OH,2020,3,3,10.70219611,4426,16.6014981818,4125,13.5480177737,8551
OH,2020,3,4,11.80439183,4522,18.3744491032,4293,15.0040805281,8815
OH,2020,3,5,15.33412464,4461,18.0793624772,4392,16.6960454105,8853
OH,2020,3,6,19.18278483,4248,23.0951271571,4404,21.1742267635,8652
OH,2020,3,7,16.99919934,4034,19.5965580058,4172,18.3197185154,8206
OH,2020,3,8,17.25435848,3788,21.8065352038,3778,19.5274385306,7566
OH,2020,3,9,13.61652706,4273,18.5479152674,3871,15.9605108211,8144
OH,2020,3,10,11.41984789,4799,15.4076990376,4572,13.3654732712,9371
OH,2020,3,11,12.67003246,5229,17.34818349,4894,14.9317010504,10123
OH,2020,3,12,14.17249669,5307,22.1413679941,5424,18.2003746094,10731
OH,2020,3,13,13.54177522,4732,18.9017578204,4955,16.2834613751,9687
OH,2020,3,14,15.04123583,4774,15.5473888385,4408,15.2842245537,9182
OH,2020,3,15,10.47991002,5114,14.1563899497,4975,12.2928238519,10089
OH,2020,3,16,8.708276564,5431,14.375882239,5163,11.470391733,10594
OH,2020,3,17,7.093568163,5465,13.5176139818,5264,10.2454161628,10729
OH,2020,3,18,6.904563245,5415,12.1374132614,5188,9.46497311814,10603
OH,2020,3,19,6.726321705,5508,13.817348456,5246,10.1854556399,10754
OH,2020,3,20,7.117783382,5161,11.5948066505,5353,9.39717329603,10514
OH,2020,3,21,5.806022467,4983,9.67634555625,4827,7.71041080052,9810
OH,2020,3,22,5.756455568,4816,10.5435429415,4739,8.13071062433,9555
OH,2020,3,23,4.53670489,5144,7.93787769784,4726,6.16527051207,9870
OH,2020,3,24,3.589994425,5373,9.01674152797,4987,6.20227123992,10360
OH,2020,3,25,4.34549594,5424,9.37575131553,5131,6.79080530351,10555
OH,2020,3,26,4.978188405,5371,9.77191344848,5153,7.32540098093,10524
OH,2020,3,27,5.088411936,5025,8.52219623389,5045,6.80871399984,10070
OH,2020,3,28,4.320028509,4911,10.173216205,4838,7.22470817599,9749
OH,2020,3,29,4.420693313,4832,10.7461785335,4705,7.54131908235,9537
OH,2020,3,30,4.000389449,5007,9.4805377456,4835,6.69257772517,9842
OH,2020,3,31,4.24159236,5137,9.33361239983,4742,6.68580321422,9879
OH,2020,4,1,3.756371587,5140,9.5200094304,5302,6.68289982352,10442
OH,2020,4,2,3.961254013,4992,8.57544180119,4708,6.20080000339,9700
OH,2020,4,3,4.827727882,4652,10.7217991193,4769,7.81136292401,9421
OH,2020,4,4,4.24344781,4484,8.86421605905,4471,6.55047794305,8955
OH,2020,4,5,3.916485386,4339,8.07666200792,4293,5.985488889,8632
OH,2020,4,6,3.400159812,4755,9.38735087321,4409,6.28072783785,9164
OH,2020,4,7,3.932258428,4999,10.7978531678,4672,7.24898458087,9671
OH,2020,4,8,4.516325886,4431,9.5784355574,4826,7.15538187327,9257
OH,2020,4,9,4.20747993,4234,9.94930232558,3956,6.98094139483,8190
OH,2020,4,10,4.907770544,4297,10.3712632529,4433,7.68207331358,8730
OH,2020,4,11,4.40553902,4165,10.2250553598,3974,7.24701314883,8139
OH,2020,4,12,3.945958722,4167,9.35895191122,4055,6.61558744765,8222
OH,2020,4,13,3.863073329,4487,8.12052843602,4220,5.92652348998,8707
OH,2020,4,14,3.504011276,4789,9.11532415631,4504,6.2236231573,9293
OH,2020,4,15,3.988128709,4724,8.41197806833,4742,6.20425945714,9466
OH,2020,4,16,4.153684418,4557,11.1755196566,4426,7.61340196959,8983
OH,2020,4,17,4.601261894,4303,10.8108078554,4481,7.76895035632,8784
OH,2020,4,18,3.623291935,4028,11.5356300663,4071,7.60046547897,8099
OH,2020,4,19,4.316697906,4055,9.96841681349,3973,7.11369332447,8028
OH,2020,4,20,3.392788881,4310,12.5163919717,4235,7.91455120856,8545
OH,2020,4,21,4.037551894,4432,7.52271418287,4167,5.72643097967,8599
OH,2020,4,22,4.632909507,4774,9.66376042632,4316,7.02159515802,9090
OH,2020,4,23,4.42945605,4927,11.0267333333,5100,7.78500747565,10027
OH,2020,4,24,3.65331708,4308,9.65058182611,4589,6.74665729804,8897
OH,2020,4,25,3.432908051,3872,8.68068037573,3939,6.07930098239,7811
OH,2020,4,26,5.330066475,3762,7.9457191601,3810,6.64618331735,7572
OH,2020,4,27,4.624768271,3949,9.46082140964,3774,6.9880033539,7723
OH,2020,4,28,3.630406979,4177,7.65254857997,4014,5.60145769153,8191
OH,2020,4,29,4.03668013,4208,9.7174863116,4018,6.81147702249,8226
OH,2020,4,30,5.746850997,4249,10.5521498054,4112,8.11013154961,8361
OH,2020,5,1,6.262487245,3920,13.6299859748,4278,10.107102952,8198
OH,2020,5,2,5.05124586,3620,12.4684063527,3652,8.77614549136,7272
OH,2020,5,3,5.263693551,3720,10.2378832515,3666,7.73260492956,7386
OH,2020,5,4,3.927644423,4050,10.1604073789,3903,6.98642398003,7953
OH,2020,5,5,4.986235263,4072,10.8609705808,3977,7.88893402795,8049
OH,2020,5,6,4.672294494,4088,10.1518451613,3875,7.33878436412,7963
OH,2020,5,7,5.118491198,4096,12.1476196411,4012,8.59664404872,8108
OH,2020,5,8,5.400214296,3733,11.3967374469,4003,8.50312047143,7736
OH,2020,5,9,5.705455301,3690,11.8395674788,3653,8.75705706941,7343
OH,2020,5,10,6.558085154,3593,11.0246983347,3663,8.81293687408,7256
OH,2020,5,11,4.779820193,3782,9.44155858311,3670,7.07565753756,7452
OH,2020,5,12,4.758028176,3834,10.3867791732,3822,7.56799242774,7656
OH,2020,5,13,4.405801008,3689,12.5911778594,3812,8.56560057572,7501
OH,2020,5,14,5.573523482,3786,9.77009168885,3381,7.5532356499,7167
OH,2020,5,15,6.896805539,3816,11.683010389,4139,9.38707604486,7955
OH,2020,5,16,5.844590666,3579,12.1799407449,3544,8.99670082741,7123
OH,2020,5,17,5.893496462,3555,11.3866817667,3532,8.63117538061,7087
OH,2020,5,18,4.927763238,3827,9.25031089484,3699,7.05227875523,7526
OH,2020,5,19,3.967774075,3904,11.8376312997,3770,7.83399270117,7674
OH,2020,5,20,4.784035916,3843,11.2431569343,3836,8.01065243198,7679
OH,2020,5,21,6.123459343,3862,12.4634212609,3791,9.26403109665,7653
OH,2020,5,22,8.119719691,3532,16.4830887826,3762,12.4332643198,7294
OH,2020,5,23,7.454565361,3382,15.7840592593,3375,11.6149977876,6757
OH,2020,5,24,7.467316934,3373,13.358682125,3407,10.4277713891,6780
OH,2020,5,25,8.470562184,3433,12.2198027314,3295,10.3067315662,6728
OH,2020,5,26,7.121647541,3660,13.565816048,3664,10.3454915347,7324
OH,2020,5,27,5.488184511,3707,12.8167981375,3651,9.12460315062,7358
OH,2020,5,28,6.380269572,4044,11.1403014687,3881,8.71133377277,7925
OH,2020,5,29,9.047321651,4036,13.2498731501,4257,11.2045942582,8293
OH,2020,5,30,8.211940905,3957,15.1267863085,4207,11.7752376483,8164
OH,2020,5,31,8.151623068,3937,12.0636880688,3956,10.1123641225,7893
OH,2020,6,1,6.504435485,3986,14.9717402978,4097,10.7962266291,8083
OH,2020,6,2,6.389360618,3957,11.7795782246,4078,9.1250553784,8035
OH,2020,6,3,6.737593666,3923,11.2920958835,3984,9.03241304562,7907
OH,2020,6,4,6.57001582,3789,12.9194369548,3783,9.74221076888,7572
OH,2020,6,5,8.330177457,3493,13.6430068277,3808,11.1012025554,7301
OH,2020,6,6,7.911438534,3288,12.4460502693,3342,10.1972111463,6630
OH,2020,6,7,9.48819514,3208,13.7392810458,3213,11.6153932423,6421
OH,2020,6,8,5.988700257,3393,12.4715599142,3263,9.16682090925,6656
OH,2020,6,9,5.885581907,3583,11.4020293537,3543,8.62832303856,7126
OH,2020,6,10,6.589654212,3644,13.1966510861,3637,9.88997664449,7281
OH,2020,6,11,8.631513368,3555,14.5372314969,3594,11.6004811894,7149
OH,2020,6,12,9.475554891,3352,17.1809185442,3462,13.3904314638,6814
OH,2020,6,13,8.04733127,3230,13.4091541353,3192,10.7123793214,6422
OH,2020,6,14,10.26196093,3279,14.9438887162,3217,12.5805818795,6496
OH,2020,6,15,9.017228114,3485,13.2711179759,3399,11.1176016818,6884
OH,2020,6,16,8.808392846,3584,16.3099132697,3459,12.4925841204,7043
OH,2020,6,17,9.867840716,3705,14.4922852282,3527,12.1231526345,7232
OH,2020,6,18,9.789472575,3735,16.833851571,3692,13.2912697008,7427
OH,2020,6,19,10.07850932,3428,18.8208460699,3664,14.5951367666,7092
OH,2020,6,20,11.83762498,3301,16.0899445813,3248,13.9465781125,6549
OH,2020,6,21,12.02034042,3378,21.5953424658,3358,16.7936267724,6736
OH,2020,6,22,8.739637703,3671,12.2464100371,3507,10.452963222,7178
OH,2020,6,23,7.450409496,3687,14.822278342,3643,11.1142182554,7330
OH,2020,6,24,8.857899798,3633,14.2175849377,3532,11.4999664991,7165
OH,2020,6,25,10.87389665,3657,13.9949512615,3488,12.397512953,7145
OH,2020,6,26,10.74758837,3396,16.3454542849,3489,13.584328265,6885
OH,2020,6,27,10.71657195,3308,16.8923860508,3269,13.7861684675,6577
OH,2020,6,28,11.73884202,3342,15.1327436603,3273,13.4180922193,6615
OH,2020,6,29,8.145184716,3545,14.6872278665,3445,11.3694105605,6990
OH,2020,6,30,7.067069968,3529,14.0203075596,3479,10.5188841206,7008
OH,2020,7,1,9.915036118,3598,19.6552379627,3593,14.781750793,7191
OH,2020,7,2,12.89713662,3674,17.0713957399,3568,14.9537171972,7242
OH,2020,7,3,11.03343909,3498,16.08762232,3638,13.6101092961,7136
OH,2020,7,4,10.35341484,3230,14.2154561934,3310,12.3080565647,6540
OH,2020,7,5,13.72691127,3325,15.9585548952,3197,14.8208340958,6522
OH,2020,7,6,12.49250619,3635,15.062606078,3488,13.7510360804,7123
OH,2020,7,7,9.622770169,3794,14.6269196553,3597,12.0581545151,7391
OH,2020,7,8,8.431779005,3901,16.4184827402,3737,12.3393872609,7638
OH,2020,7,9,8.45008595,3839,15.0522085407,3817,11.741661437,7656
OH,2020,7,10,12.20210113,3479,16.9896719548,3719,14.6757015603,7198
OH,2020,7,11,10.07157865,3370,15.2415195498,3376,12.6588482138,6746
OH,2020,7,12,13.63235812,3384,16.60971078,3423,15.1295636665,6807
OH,2020,7,13,11.0144979,3635,15.2356620209,3444,13.0681338984,7079
OH,2020,7,14,7.126491885,3814,15.1968788732,3550,11.0170233636,7364
OH,2020,7,15,8.272298959,3780,15.293936366,3803,11.793766328,7583
OH,2020,7,16,9.706330766,3622,14.5781456954,3624,12.1429105761,7246
OH,2020,7,17,10.39039836,3364,17.2387351106,3526,13.8950769351,6890
OH,2020,7,18,10.80131611,3328,17.3117495396,3258,14.0219344085,6586
OH,2020,7,19,12.63992101,3418,16.7386225403,3354,14.6699040183,6772
OH,2020,7,20,8.128809987,3521,16.9163103149,3461,12.4848023438,6982
OH,2020,7,21,7.698789985,3686,14.4438243547,3564,11.0145558462,7250
OH,2020,7,22,7.650047533,3790,14.8547917793,3698,11.2081597423,7488
OH,2020,7,23,10.52634515,3784,15.5350263852,3790,13.0326696656,7574
OH,2020,7,24,12.5234532,3504,19.4715364168,3762,16.1208505385,7266
OH,2020,7,25,9.766532571,3331,15.3022008996,3335,12.5360276019,6666
OH,2020,7,26,10.55821594,3352,16.8495664379,3206,13.6338593826,6558
OH,2020,7,27,7.957990576,3598,17.6548645533,3470,12.718623386,7068
OH,2020,7,28,7.999919821,3741,13.1762055768,3658,10.5590296054,7399
OH,2020,7,29,9.056011584,3791,14.2077135061,3665,11.5883328749,7456
OH,2020,7,30,12.31982561,3728,15.1554486835,3722,13.7364952851,7450
OH,2020,7,31,11.87582641,3364,17.131331637,3537,14.5694537086,6901
OK,2020,1,1,24.64289387,1282,31.3097931034,1305,28.0059798768,2587
OK,2020,1,2,21.97252441,1232,24.092761578,1166,23.0034654183,2398
OK,2020,1,3,21.10332801,1271,31.427773344,1253,26.2287360938,2524
OK,2020,1,4,19.67947328,1215,23.056133979,1239,21.3843154178,2454
OK,2020,1,5,21.80665557,1205,23.6306065712,1187,22.7117683787,2392
OK,2020,1,6,18.53943033,1299,25.8793577236,1230,22.1092645309,2529
OK,2020,1,7,14.9440647,1267,22.4787968127,1255,18.6935051447,2522
OK,2020,1,8,20.28322623,1339,29.3254522613,1194,24.5455309601,2533
OK,2020,1,9,20.30331941,1440,22.001961223,1341,21.1224055917,2781
OK,2020,1,10,23.0316629,1323,28.7912079063,1366,25.9574860605,2689
OK,2020,1,11,22.96494051,1261,22.3089710611,1244,22.63918163,2505
OK,2020,1,12,21.96168022,1357,27.4501594896,1254,24.5976637528,2611
OK,2020,1,13,17.76690529,1509,29.6489257951,1415,23.5169254728,2924
OK,2020,1,14,14.97263877,1152,23.6564423765,1397,19.7318673452,2549
OK,2020,1,15,15.33917887,1023,20.8669525959,886,17.9047145018,1909
OK,2020,1,16,15.59503441,1307,17.1208598452,1163,16.313469625,2470
OK,2020,1,17,23.21632103,1321,22.7627321157,1314,22.9901290629,2635
OK,2020,1,18,23.18854265,1290,23.9791169451,1257,23.5787082915,2547
OK,2020,1,19,27.87052895,1248,35.8060436137,1284,31.8946998932,2532
OK,2020,1,20,20.34311952,1247,26.4273203719,1183,23.3050987825,2430
OK,2020,1,21,16.10222477,1326,26.1199308224,1301,21.0634107518,2627
OK,2020,1,22,16.57601973,1319,22.8873603673,1307,19.7172696207,2626
OK,2020,1,23,20.3544131,1346,25.8951267829,1262,23.0355406567,2608
OK,2020,1,24,18.5757687,1262,27.9504818325,1266,23.2705419697,2528
OK,2020,1,25,17.63014638,1298,20.3858008299,1205,18.9567798647,2503
OK,2020,1,26,22.88311575,1348,21.879595537,1434,22.3658447272,2782
OK,2020,1,27,16.1686987,1268,24.0726833333,1200,20.0118030598,2468
OK,2020,1,28,14.24645522,1309,26.7376910299,1204,20.2311141596,2513
OK,2020,1,29,17.03739882,1334,22.2436842105,1273,19.5796317706,2607
OK,2020,1,30,22.54385432,1318,23.4386166667,1200,22.9702700531,2518
OK,2020,1,31,21.30775701,1284,30.0502142311,1307,25.717788499,2591
OK,2020,2,1,22.14846682,1324,29.2573466135,1255,25.6078092554,2579
OK,2020,2,2,17.86015555,900,23.3056254417,1415,21.1885961102,2315
OK,2020,2,3,17.51246861,794,25.8563782051,624,21.1842595743,1418
OK,2020,2,4,13.79326994,1315,18.4065274151,1149,15.9445008,2464
OK,2020,2,5,16.23771883,1337,21.2962170448,1631,19.0175067641,2968
OK,2020,2,6,17.79906701,568,21.4490562613,1102,20.2076227914,1670
OK,2020,2,7,13.63424144,646,10.8333820459,479,12.4416977513,1125
OK,2020,2,8,18.18650245,1238,22.7869641368,1199,20.4499220489,2437
OK,2020,2,9,24.28699824,1126,23.8538753159,1187,24.0647254727,2313
OK,2020,2,10,15.55431959,1139,23.3611204482,1071,19.3376153905,2210
OK,2020,2,11,13.21159822,1145,23.213175853,1143,18.2080157176,2288
OK,2020,2,12,18.08666387,1163,16.077883349,1063,17.1273944658,2226
OK,2020,2,13,25.20065909,1320,27.3933706966,1249,26.2667146745,2569
OK,2020,2,14,24.46519999,1200,29.4313785047,1284,27.0322584493,2484
OK,2020,2,15,19.87268349,1103,21.3307522124,1130,20.6105328659,2233
OK,2020,2,16,27.79920642,1109,22.964599816,1087,25.406120182,2196
OK,2020,2,17,20.74227235,1241,24.7054040404,1188,22.6806010648,2429
OK,2020,2,18,16.41343944,1256,23.7970431894,1204,20.0272032263,2460
OK,2020,2,19,16.60747838,1273,23.1948812261,1305,19.9420636066,2578
OK,2020,2,20,21.27319419,1246,26.6321283784,1184,23.8842962801,2430
OK,2020,2,21,21.42857602,1236,26.817970297,1212,24.0968545591,2448
OK,2020,2,22,21.56558624,1126,28.5944718962,1619,25.7112204394,2745
OK,2020,2,23,23.53796461,1130,26.1304549509,1121,24.8290271032,2251
OK,2020,2,24,16.7750236,1268,24.7346529563,1167,20.5897617761,2435
OK,2020,2,25,16.1232172,1262,22.2398287113,1226,19.1372709431,2488
OK,2020,2,26,22.50226578,1249,25.0291372227,1217,23.7493065528,2466
OK,2020,2,27,21.90021381,1310,24.7367396594,1233,23.2755328711,2543
OK,2020,2,28,24.80565585,1273,33.1931691297,1218,28.9068164982,2491
OK,2020,2,29,29.34937454,1151,25.8685605419,1181,27.5865780856,2332
OK,2020,3,1,32.35970748,1162,31.7896261682,1070,32.0864158117,2232
OK,2020,3,2,20.45768123,1255,26.0262726488,1159,23.1312510123,2414
OK,2020,3,3,18.81306758,1317,22.1848995363,1294,20.4841325174,2611
OK,2020,3,4,17.7787684,1226,26.5617748562,1217,22.1540933518,2443
OK,2020,3,5,19.58548234,1275,30.0412672624,1231,24.7215841913,2506
OK,2020,3,6,23.35886547,1234,34.5767556952,1273,29.0550658117,2507
OK,2020,3,7,24.89174402,1164,23.2996592845,1174,24.0922968517,2338
OK,2020,3,8,20.91055803,1147,24.3439672978,1162,22.6384149244,2309
OK,2020,3,9,14.99219301,1254,22.6154778157,1172,18.6750000142,2426
OK,2020,3,10,17.56714783,1441,20.7378432894,1289,19.0642271147,2730
OK,2020,3,11,17.77680333,1708,22.2842182514,1567,19.9334809428,3275
OK,2020,3,12,20.72784336,1609,25.3299575243,1648,23.0564537815,3257
OK,2020,3,13,22.32280924,1342,25.8336173184,1432,24.1351658256,2774
OK,2020,3,14,16.90887784,1212,21.4501710864,1169,19.1385174053,2381
OK,2020,3,15,19.15119465,1264,21.3641151203,1164,20.2120840353,2428
OK,2020,3,16,14.22809956,1405,20.033655994,1343,17.0653856921,2748
OK,2020,3,17,11.60110133,1471,19.3623170732,1394,15.3774136323,2865
OK,2020,3,18,9.651242964,1424,19.2657669617,1356,14.3409172593,2780
OK,2020,3,19,11.71941956,1447,19.5207290133,1358,15.4963101973,2805
OK,2020,3,20,10.63623587,1416,20.3607821982,1483,15.6108830603,2899
OK,2020,3,21,12.81637705,1358,14.3984460967,1345,13.6036071158,2703
OK,2020,3,22,10.75273574,1294,12.4516679657,1283,11.5985758819,2577
OK,2020,3,23,7.480913588,1434,14.8460722181,1357,11.0618954085,2791
OK,2020,3,24,5.932921781,1482,16.0150138889,1440,10.9015092674,2922
OK,2020,3,25,7.957832473,1504,15.8209233926,1462,11.8337053403,2966
OK,2020,3,26,8.780294104,1496,17.1994986631,1496,12.9898963836,2992
OK,2020,3,27,10.91477967,1362,18.5293296475,1447,14.8372623391,2809
OK,2020,3,28,7.170300039,1300,16.2268654311,1241,11.5934396107,2541
OK,2020,3,29,9.835003873,1293,16.2255161787,1298,13.0364260933,2591
OK,2020,3,30,6.839186187,1364,16.7851884701,1353,11.7920537207,2717
OK,2020,3,31,6.548457153,1400,15.2637941628,1302,10.7480755049,2702
OK,2020,4,1,7.556159472,1367,20.5495758447,1391,14.1094017397,2758
OK,2020,4,2,8.450603693,1375,12.7036486486,1332,10.5433469072,2707
OK,2020,4,3,7.493809873,1336,15.4397364458,1328,11.4548423387,2664
OK,2020,4,4,5.307173399,1263,12.3919575114,1318,8.92505230645,2581
OK,2020,4,5,8.459247129,1222,13.3067842149,1191,10.8518773277,2413
OK,2020,4,6,6.452542758,1286,12.0867100977,1228,9.20463404407,2514
OK,2020,4,7,8.634967795,1399,13.8071017871,1287,11.1132017666,2686
OK,2020,4,8,7.542375512,1225,19.2972995461,1322,13.6436749125,2547
OK,2020,4,9,7.914569677,1162,13.8349809886,1052,10.7277009777,2214
OK,2020,4,10,9.440904456,1172,17.1497342193,1204,13.3472306492,2376
OK,2020,4,11,5.26020506,1219,17.3853108808,1158,11.1671771006,2377
OK,2020,4,12,8.210459002,1242,14.3363448276,1160,11.1688385015,2402
OK,2020,4,13,5.537871292,1259,13.518195242,1219,9.46362387273,2478
OK,2020,4,14,8.062661,1289,13.6250284784,1229,10.7775734825,2518
OK,2020,4,15,6.939715457,1230,20.2283710055,1283,13.7241742985,2513
OK,2020,4,16,8.162965394,1214,14.0296646604,1163,11.0333782029,2377
OK,2020,4,17,7.732130901,1131,15.9739612676,1136,11.8621350018,2267
OK,2020,4,18,7.792552668,1093,16.9221037998,1079,12.327905187,2172
OK,2020,4,19,10.10346228,1138,17.709040724,1105,13.8503031987,2243
OK,2020,4,20,11.20940722,1164,12.8224021352,1124,12.0018050717,2288
OK,2020,4,21,8.081418842,1177,15.8788650581,1119,11.8816550423,2296
OK,2020,4,22,8.145277729,1260,17.7121090047,1266,12.9400553993,2526
OK,2020,4,23,9.912135571,1269,16.934548336,1262,13.4136309915,2531
OK,2020,4,24,10.74518082,1106,18.9351517707,1186,14.9830977255,2292
OK,2020,4,25,8.415669645,993,14.9555984556,1036,11.7549334438,2029
OK,2020,4,26,9.560930701,1010,13.0374974147,967,11.261406175,1977
OK,2020,4,27,7.690620413,1080,16.1698767967,974,11.7114557186,2054
OK,2020,4,28,9.082997298,1131,14.7820888889,1125,11.9249645142,2256
OK,2020,4,29,8.47683925,1101,15.7274762808,1054,12.0230904939,2155
OK,2020,4,30,12.21031828,1131,18.5009245961,1114,15.3318039976,2245
OK,2020,5,1,13.18486899,992,23.2399151104,1178,18.6433225982,2170
OK,2020,5,2,9.053132406,929,19.4035897436,975,14.3533928599,1904
OK,2020,5,3,9.761983745,983,27.1364232804,945,18.2779823762,1928
OK,2020,5,4,7.772921594,1109,20.0853568282,1135,14.0004679357,2244
OK,2020,5,5,7.767551515,1115,18.8589933523,1053,13.1546770937,2168
OK,2020,5,6,10.92941972,1103,17.5810651974,1089,14.2340008901,2192
OK,2020,5,7,11.41789476,1083,18.2773113208,1060,14.8107932922,2143
OK,2020,5,8,11.17683519,989,17.4092183288,1113,14.4768553772,2102
OK,2020,5,9,11.45551758,966,22.0855661376,945,16.7121349986,1911
OK,2020,5,10,14.52480337,966,27.0979209979,962,20.7983195308,1928
OK,2020,5,11,7.838816783,1048,19.8472216331,943,13.5263736758,1991
OK,2020,5,12,11.05251398,1078,17.2584341979,1041,14.101293096,2119
OK,2020,5,13,9.665823171,984,19.7613636364,1034,14.8386620418,2018
OK,2020,5,14,11.66476981,1021,17.9267002237,894,14.5880939823,1915
OK,2020,5,15,12.31874768,1070,23.7813898601,1144,18.2416305409,2214
OK,2020,5,16,11.53874218,962,15.5249619772,1052,13.6209185587,2014
OK,2020,5,17,16.90700212,954,20.5713405405,925,18.7108941046,1879
OK,2020,5,18,10.39375608,1033,20.2531858407,1017,15.2849951369,2050
OK,2020,5,19,10.69960294,1083,18.7475480769,1040,14.6420725313,2123
OK,2020,5,20,12.40517852,1120,18.4140656064,1006,15.2485183172,2126
OK,2020,5,21,12.29738884,1080,22.3088389513,1068,17.2751489512,2148
OK,2020,5,22,15.10288049,979,26.2730747664,1070,20.9360224498,2049
OK,2020,5,23,15.37178014,955,23.764765625,896,19.4345110933,1851
OK,2020,5,24,16.99414527,977,19.313736952,958,18.1425529348,1935
OK,2020,5,25,13.38424674,989,24.9292173018,971,19.1037194009,1960
OK,2020,5,26,12.86886943,1026,22.2656909789,1042,17.6036315451,2068
OK,2020,5,27,13.03155472,1042,22.550504451,1011,17.7191622105,2053
OK,2020,5,28,13.17937729,1108,29.8278836988,1049,21.2759388212,2157
OK,2020,5,29,14.96733144,1068,20.0746572935,1138,17.6020262819,2206
OK,2020,5,30,15.32375826,1059,23.808361809,995,19.4338753638,2054
OK,2020,5,31,19.650795,1132,22.7555490849,1202,21.2497300514,2334
OK,2020,6,1,15.30739313,1193,29.2307048093,1206,22.3067736574,2399
OK,2020,6,2,11.02207772,1107,19.605612069,1160,15.4141817539,2267
OK,2020,6,3,11.72925285,1044,26.6675637394,1059,19.2516832979,2103
OK,2020,6,4,11.07673983,1049,20.3551231061,1056,15.7313587086,2105
OK,2020,6,5,14.7895478,995,21.3103963964,1110,18.2280950409,2105
OK,2020,6,6,14.47824235,916,25.6382586558,982,20.2522866136,1898
OK,2020,6,7,11.08968177,817,23.4127838428,916,17.6032198535,1733
OK,2020,6,8,12.86242976,926,24.1072687225,908,18.4296673706,1834
OK,2020,6,9,13.43170252,1069,18.9935769981,1026,16.1555608563,2095
OK,2020,6,10,13.93704423,1086,17.5731226415,1060,15.7330568657,2146
OK,2020,6,11,16.31006533,1071,28.5532799246,1061,22.4029596475,2132
OK,2020,6,12,15.74763909,953,26.5718649194,992,21.2682725207,1945
OK,2020,6,13,16.99937114,954,28.4603475336,892,22.5373944028,1846
OK,2020,6,14,17.30312565,963,23.8136245955,927,20.4963703709,1890
OK,2020,6,15,12.95205855,1059,24.4469047619,1008,18.5576729581,2067
OK,2020,6,16,12.22941067,1052,19.3408293153,1037,15.7595883317,2089
OK,2020,6,17,13.39410531,1140,20.6276207513,1118,16.9756244701,2258
OK,2020,6,18,14.91536288,1171,23.9227425044,1134,19.3467591898,2305
OK,2020,6,19,18.7734262,1220,27.5395038494,1169,23.0628965944,2389
OK,2020,6,20,17.39276501,1179,38.5891183295,1293,28.4796925351,2472
OK,2020,6,21,24.12938809,1095,53.7642984014,1126,39.1536604946,2221
OK,2020,6,22,12.90211846,996,23.1443693239,991,18.0103573156,1987
OK,2020,6,23,16.50789634,1003,23.2211992071,1009,19.8745576685,2012
OK,2020,6,24,12.76496015,1002,21.5693551689,977,17.111546271,1979
OK,2020,6,25,13.62632183,1044,19.9088104449,1034,16.7524494661,2078
OK,2020,6,26,15.99235526,1036,24.2156073858,1029,20.0900436074,2065
OK,2020,6,27,16.92912281,969,25.0833366142,1016,21.1027657445,1985
OK,2020,6,28,19.2623085,992,23.3907723577,984,21.3181832146,1976
OK,2020,6,29,12.85130437,1127,21.9043343343,999,17.1052916392,2126
OK,2020,6,30,12.56092527,1124,19.1197155556,1125,15.8417785698,2249
OK,2020,7,1,16.64578067,1076,29.7242242152,1115,23.3014011871,2191
OK,2020,7,2,14.17573776,1037,27.8837476281,1054,21.0854663114,2091
OK,2020,7,3,16.43143848,1015,28.0827042802,1028,22.2941409972,2043
OK,2020,7,4,16.70270021,974,28.403762279,1018,22.6824598416,1992
OK,2020,7,5,17.4429884,947,33.529833887,903,25.2951081161,1850
OK,2020,7,6,15.84102915,1030,27.9410662526,966,21.6970591305,1996
OK,2020,7,7,14.42633557,1067,29.2110865562,1086,21.8839480043,2153
OK,2020,7,8,14.18354409,1044,25.3411223551,1087,19.8749038151,2131
OK,2020,7,9,13.54664914,1146,21.4201379945,1087,17.3793774807,2233
OK,2020,7,10,14.93408786,1047,22.2877289048,1114,18.7249051316,2161
OK,2020,7,11,20.42445419,1026,26.352009901,1010,23.3649410604,2036
OK,2020,7,12,16.79039589,985,23.4950861196,987,20.1461409491,1972
OK,2020,7,13,12.41532708,1070,28.6975972084,1003,20.2933381455,2073
OK,2020,7,14,11.04931219,1134,21.6412815534,1030,16.090776351,2164
OK,2020,7,15,10.85442774,1127,23.4757104796,1126,17.1622681149,2253
OK,2020,7,16,18.20738116,1115,28.7034990792,1086,23.3862925913,2201
OK,2020,7,17,17.26144253,1026,27.0789689781,1096,22.3321347954,2122
OK,2020,7,18,21.31415348,1004,22.5932116788,959,21.9390219531,1963
OK,2020,7,19,20.92201194,1014,21.9142977825,947,21.4012035223,1961
OK,2020,7,20,15.02078746,1092,24.8705751391,1078,19.9139077909,2170
OK,2020,7,21,16.5185871,1090,21.078217636,1066,18.7730240904,2156
OK,2020,7,22,13.47668527,1074,25.0572816487,1019,19.1148255996,2093
OK,2020,7,23,15.75195668,1109,27.6387074236,1145,21.7902573017,2254
OK,2020,7,24,19.89389711,1011,29.8074860335,1074,25.0004652174,2085
OK,2020,7,25,16.72321865,901,25.0833723404,940,20.9918468244,1841
OK,2020,7,26,18.3078389,981,28.2482491582,891,23.0390918595,1872
OK,2020,7,27,14.30486436,1032,26.6530866602,1027,20.4639825253,2059
OK,2020,7,28,11.01105509,1033,17.741375,1040,14.3875783444,2073
OK,2020,7,29,13.07102888,1040,24.1976358149,994,18.5085152582,2034
OK,2020,7,30,16.06314724,1039,21.6414201763,1021,18.8279126128,2060
OK,2020,7,31,18.30624238,982,28.1880574163,1045,23.4007153513,2027
OR,2020,1,1,39.74945672,1454,45.313611809,1592,42.6575771736,3046
OR,2020,1,2,33.57308116,1428,32.1617517136,1313,32.8970229465,2741
OR,2020,1,3,27.32385275,1386,29.6157345265,1341,28.4508837226,2727
OR,2020,1,4,29.34394639,1419,27.0744394281,1329,28.2463573244,2748
OR,2020,1,5,34.75068051,1381,30.1901790831,1396,32.458112994,2777
OR,2020,1,6,20.76342854,1470,22.0670999249,1331,21.3829167989,2801
OR,2020,1,7,22.65187206,1469,22.625557971,1380,22.6391260288,2849
OR,2020,1,8,23.52672233,1495,28.0405763689,1388,25.6998854954,2883
OR,2020,1,9,20.94942336,1526,29.7648452221,1486,25.2985989533,3012
OR,2020,1,10,29.76701433,1400,30.4742061856,1455,30.1274220883,2855
OR,2020,1,11,23.42680304,1345,21.4805344694,1291,22.4736039791,2636
OR,2020,1,12,32.60921275,1448,36.0391440799,1402,34.2964982674,2850
OR,2020,1,13,23.16194098,1561,33.4931818182,1408,28.0613640518,2969
OR,2020,1,14,18.10158385,1288,30.0527692308,1560,24.6478792131,2848
OR,2020,1,15,21.37545456,1144,17.7269939271,988,19.6847045106,2132
OR,2020,1,16,26.42326009,1457,29.4364724409,1270,27.8265529707,2727
OR,2020,1,17,24.01021024,1474,29.5159480519,1540,26.8233609468,3014
OR,2020,1,18,23.75342567,1442,26.2464475628,1354,24.9607045122,2796
OR,2020,1,19,30.42148081,1418,28.1140589888,1424,29.2653341972,2842
OR,2020,1,20,30.49233139,1467,29.8332708934,1388,30.1719194918,2855
OR,2020,1,21,26.24232311,1498,27.4379151943,1415,26.8230861719,2913
OR,2020,1,22,26.70795665,1522,19.5068063584,1384,23.2783654581,2906
OR,2020,1,23,32.10927358,1542,32.8192432815,1414,32.4488869622,2956
OR,2020,1,24,32.98549932,1482,36.0592011019,1452,34.5066359892,2934
OR,2020,1,25,25.42568725,1477,20.851311828,1395,23.2038022522,2872
OR,2020,1,26,35.1514897,1450,26.7822326454,1599,30.7623647311,3049
OR,2020,1,27,20.68428354,1403,23.9140377062,1273,22.2207099427,2676
OR,2020,1,28,20.19930781,1459,27.67356236,1339,23.7761580039,2798
OR,2020,1,29,24.77372862,1577,25.7270435393,1424,25.2260846497,3001
OR,2020,1,30,28.66445482,1596,30.1521298701,1540,29.3950095321,3136
OR,2020,1,31,36.99126826,1569,26.2385825243,1545,31.6563615607,3114
OR,2020,2,1,30.95559158,1572,36.1708554377,1508,33.5090389493,3080
OR,2020,2,2,22.18192045,1005,26.982168906,1563,25.1035669985,2568
OR,2020,2,3,34.08456175,833,15.1072766571,694,25.4596528734,1527
OR,2020,2,4,21.47875548,1350,24.665564589,1107,22.9145705731,2457
OR,2020,2,5,24.34306941,1453,27.5329019346,1499,25.9628387035,2952
OR,2020,2,6,35.97292016,767,27.5177534039,1322,30.6221636011,2089
OR,2020,2,7,17.9499532,857,7.29364548495,598,13.5702473487,1455
OR,2020,2,8,24.08498964,1431,23.4247612457,1445,23.7532684892,2876
OR,2020,2,9,34.39235565,1316,31.9149403875,1342,33.1415312398,2658
OR,2020,2,10,20.56110447,1331,30.1365444173,1227,25.1541712469,2558
OR,2020,2,11,17.26361083,1357,23.917342445,1317,20.5407105072,2674
OR,2020,2,12,25.55477368,1414,24.6285785124,1210,25.1276791096,2624
OR,2020,2,13,32.43373175,1581,27.9492464789,1420,30.3117827047,3001
OR,2020,2,14,28.92453378,1480,37.5747919463,1490,33.2642255873,2970
OR,2020,2,15,25.87110714,1391,17.8903946389,1343,21.950808351,2734
OR,2020,2,16,36.40362458,1396,31.3100071582,1397,33.8559040149,2793
OR,2020,2,17,30.55121954,1386,37.0776582761,1311,33.7236930969,2697
OR,2020,2,18,29.37528983,1467,26.2272239264,1304,27.8938470518,2771
OR,2020,2,19,24.18141186,1544,28.5753573907,1441,26.3025761849,2985
OR,2020,2,20,32.40001288,1546,28.7293214286,1400,30.655624546,2946
OR,2020,2,21,28.10647766,1499,24.3423849965,1413,26.2800137405,2912
OR,2020,2,22,25.12572219,1412,30.7216818182,1760,28.2306682636,3172
OR,2020,2,23,32.69933783,1374,35.0489992532,1339,33.8590122294,2713
OR,2020,2,24,26.05778842,1465,30.4059637681,1380,28.1669209263,2845
OR,2020,2,25,27.99414265,1487,31.3877738764,1424,29.6542356993,2911
OR,2020,2,26,24.57359695,1479,28.7401875902,1386,26.589266977,2865
OR,2020,2,27,28.18691028,1518,41.3899148936,1410,34.5449145509,2928
OR,2020,2,28,30.09516062,1494,29.8673333333,1470,29.9821693543,2964
OR,2020,2,29,30.37933868,1391,31.209567643,1434,30.8007717182,2825
OR,2020,3,1,31.43724853,1363,30.3416666667,1308,30.9007374565,2671
OR,2020,3,2,30.36862592,1412,26.8137713841,1286,28.6742067454,2698
OR,2020,3,3,23.79305479,1496,22.0824072778,1429,22.9573230652,2925
OR,2020,3,4,25.93480327,1499,22.7567410072,1390,24.4057251996,2889
OR,2020,3,5,30.70101243,1531,29.0705211953,1439,29.9110202122,2970
OR,2020,3,6,33.93981348,1501,27.1447182621,1473,30.5742535419,2974
OR,2020,3,7,27.39686693,1398,28.7020119671,1337,28.0348848147,2735
OR,2020,3,8,27.57392182,1354,22.3049512378,1333,24.9600261051,2687
OR,2020,3,9,29.21505275,1423,23.3577396726,1283,26.4379157662,2706
OR,2020,3,10,17.47120735,1557,29.635630662,1435,23.3054143863,2992
OR,2020,3,11,15.69923602,1741,24.6902363184,1608,20.0162048106,3349
OR,2020,3,12,22.62967828,1835,20.7302252747,1820,21.6838494237,3655
OR,2020,3,13,21.41173495,1758,24.3071274788,1765,22.8623077043,3523
OR,2020,3,14,15.80438864,1652,18.2471880706,1643,17.0224522104,3295
OR,2020,3,15,18.94413615,1615,19.3511791531,1535,19.1424888515,3150
OR,2020,3,16,14.70065918,1775,27.9626249247,1661,21.1116385461,3436
OR,2020,3,17,13.6963774,1786,16.6526767092,1726,15.1492739284,3512
OR,2020,3,18,11.13102559,1765,17.5564888628,1706,14.2891472677,3471
OR,2020,3,19,9.15422183,1812,15.8304216867,1660,12.3461837431,3472
OR,2020,3,20,9.217751821,1757,16.6711257551,1821,13.0110983649,3578
OR,2020,3,21,9.428081967,1658,17.279945685,1657,13.3528295328,3315
OR,2020,3,22,11.95096537,1585,14.051928934,1576,12.99845622,3161
OR,2020,3,23,9.05667857,1677,14.3413354633,1565,11.6077236156,3242
OR,2020,3,24,9.830800334,1737,9.76101204819,1660,9.7966971387,3397
OR,2020,3,25,10.91980366,1681,14.1683031815,1603,12.505475016,3284
OR,2020,3,26,9.665870146,1695,14.8779817073,1640,12.2289474955,3335
OR,2020,3,27,10.72001214,1645,15.1425605327,1652,12.935981186,3297
OR,2020,3,28,9.569207925,1616,19.7523818898,1524,14.5116146518,3140
OR,2020,3,29,11.85865307,1574,14.6839393939,1518,13.2457114916,3092
OR,2020,3,30,9.569255369,1598,18.9714738929,1513,14.1419190227,3111
OR,2020,3,31,6.680119457,1674,15.3393109987,1582,10.8873802122,3256
OR,2020,4,1,8.154049752,1689,19.8566772152,1580,13.8102600279,3269
OR,2020,4,2,8.073377713,1652,21.0025422627,1538,14.3069372984,3190
OR,2020,4,3,9.358149998,1573,21.7022215068,1553,15.4906973598,3126
OR,2020,4,4,10.55693413,1533,22.8319363395,1508,16.6439789613,3041
OR,2020,4,5,10.92792135,1501,18.2849788434,1418,14.5018533561,2919
OR,2020,4,6,7.758028381,1547,14.5491,1400,10.9841906703,2947
OR,2020,4,7,7.308251293,1687,19.4087012113,1486,12.9752127108,3173
OR,2020,4,8,10.43350893,1519,14.174830887,1567,12.3332663852,3086
OR,2020,4,9,11.71980653,1447,16.6704950495,1313,14.0749710322,2760
OR,2020,4,10,7.220060461,1489,14.9731668947,1462,11.0611453834,2951
OR,2020,4,11,8.851385794,1436,19.433139881,1344,13.9671690648,2780
OR,2020,4,12,7.283411915,1357,9.55753188297,1333,8.41032712589,2690
OR,2020,4,13,8.021229389,1456,11.8138888889,1332,9.83321735667,2788
OR,2020,4,14,6.195561514,1487,20.2236558397,1447,13.113984312,2934
OR,2020,4,15,6.815105327,1471,14.1563446287,1387,10.3778411253,2858
OR,2020,4,16,7.535336451,1486,18.3842082739,1402,12.8019979107,2888
OR,2020,4,17,5.746098366,1443,16.5176780822,1460,11.1634274689,2903
OR,2020,4,18,6.337983514,1334,14.1062191358,1296,10.1659809915,2630
OR,2020,4,19,7.940645823,1316,16.7203846154,1326,12.3471309247,2642
OR,2020,4,20,10.94691858,1337,18.8118188915,1281,14.7952521549,2618
OR,2020,4,21,11.14937363,1389,19.8247644788,1295,15.3351527467,2684
OR,2020,4,22,10.32239617,1469,13.1837635968,1379,11.7078686706,2848
OR,2020,4,23,7.518990711,1506,13.904235377,1419,10.6166529951,2925
OR,2020,4,24,11.46395951,1384,18.8711543909,1412,15.2046459091,2796
OR,2020,4,25,10.88566537,1255,19.8656117825,1324,15.495765816,2579
OR,2020,4,26,9.482998402,1224,11.7438514091,1171,10.5884092042,2395
OR,2020,4,27,7.588064016,1281,13.7840617384,1231,10.6243988871,2512
OR,2020,4,28,5.919827576,1334,15.2684297521,1210,10.3662932336,2544
OR,2020,4,29,12.46148859,1357,14.5945773525,1254,13.4859594089,2611
OR,2020,4,30,15.72439975,1441,15.0945398299,1293,15.426517937,2734
OR,2020,5,1,13.26882221,1333,30.434477304,1454,22.2242805906,2787
OR,2020,5,2,10.73996803,1251,17.5395977474,1243,14.1288773078,2494
OR,2020,5,3,11.31607715,1244,20.8907004219,1185,15.9871057944,2429
OR,2020,5,4,9.265366375,1310,17.694147351,1208,13.3090389004,2518
OR,2020,5,5,10.80832831,1334,19.6865821813,1302,15.193565996,2636
OR,2020,5,6,11.1899693,1302,20.8091549296,1207,15.81745318,2509
OR,2020,5,7,12.19656955,1306,20.7734984026,1252,16.3945034528,2558
OR,2020,5,8,13.23808748,1234,17.584215918,1269,15.4415381344,2503
OR,2020,5,9,8.893025035,1200,22.6140760389,1131,15.5504719185,2331
OR,2020,5,10,11.0177853,1174,16.2218657367,1147,13.5895562009,2321
OR,2020,5,11,8.304404515,1226,23.5525552608,1131,15.6211879234,2357
OR,2020,5,12,6.892321178,1258,14.1398013245,1208,10.4425872027,2466
OR,2020,5,13,11.74419935,1174,24.2620493827,1215,18.1105399903,2389
OR,2020,5,14,10.8908129,1181,19.7286087768,1071,15.0938676887,2252
OR,2020,5,15,16.71125832,1192,21.9597011309,1238,19.3851563446,2430
OR,2020,5,16,14.21632213,1229,25.9521694915,1180,19.9648899534,2409
OR,2020,5,17,9.997950155,1205,16.4011197244,1161,13.1399957467,2366
OR,2020,5,18,9.999743624,1287,15.0194750212,1181,12.401811201,2468
OR,2020,5,19,9.352012462,1287,15.8455358582,1241,12.5396954267,2528
OR,2020,5,20,10.65399693,1301,22.8023870968,1240,16.5823730838,2541
OR,2020,5,21,10.98195465,1279,18.2303355155,1222,14.5235465803,2501
OR,2020,5,22,9.228594317,1245,20.2456099518,1246,14.7393134985,2491
OR,2020,5,23,10.11758825,1161,21.5527986051,1147,15.8005112471,2308
OR,2020,5,24,8.493061755,1117,18.8076502732,1098,13.6061173726,2215
OR,2020,5,25,12.34554897,1184,28.3462144821,1091,20.0188351563,2275
OR,2020,5,26,7.645108266,1247,19.7206689537,1166,13.4802113584,2413
OR,2020,5,27,6.843116803,1293,15.4739586777,1210,11.0154374855,2503
OR,2020,5,28,11.77579114,1340,25.5600227618,1318,18.610861598,2658
OR,2020,5,29,13.00713333,1329,21.0117416974,1355,17.0482079715,2684
OR,2020,5,30,7.739660034,1353,14.4130307263,1432,11.1709946233,2785
OR,2020,5,31,10.35985531,1313,17.918754717,1325,14.1564973548,2638
OR,2020,6,1,9.805323578,1375,28.0899572954,1405,19.0462985323,2780
OR,2020,6,2,11.35032008,1437,14.4922875817,1377,12.8878073756,2814
OR,2020,6,3,6.854165429,1390,18.5718772827,1369,12.6684269468,2759
OR,2020,6,4,8.372876546,1328,15.3725774754,1323,11.8661260102,2651
OR,2020,6,5,8.277201532,1265,14.0214429012,1296,11.1840882226,2561
OR,2020,6,6,10.85502898,1207,18.5919047619,1218,14.7410144243,2425
OR,2020,6,7,12.85046743,1155,22.2267649468,1221,17.6688425428,2376
OR,2020,6,8,7.624498775,1187,26.4148085485,1123,16.7593549982,2310
OR,2020,6,9,8.214803584,1222,15.7840536013,1194,11.9555670446,2416
OR,2020,6,10,12.18067501,1274,23.1515754561,1206,17.5157177269,2480
OR,2020,6,11,12.19298663,1269,19.217208,1250,15.6786066032,2519
OR,2020,6,12,11.74237417,1192,16.03765625,1216,13.9114202702,2408
OR,2020,6,13,15.72275713,1099,19.0779749104,1116,17.4132415738,2215
OR,2020,6,14,13.02910272,1081,13.3403474178,1065,13.1835647905,2146
OR,2020,6,15,10.89335671,1141,26.5368047882,1086,18.5219083997,2227
OR,2020,6,16,9.786280251,1156,17.8308939527,1141,13.7823204049,2297
OR,2020,6,17,10.59913182,1221,17.8019948409,1163,14.1129446108,2384
OR,2020,6,18,12.00654529,1236,27.3675127768,1174,19.4894398251,2410
OR,2020,6,19,17.84100744,1221,21.7193872549,1224,19.7825767216,2445
OR,2020,6,20,15.60610617,1148,14.326838932,1161,14.9628713223,2309
OR,2020,6,21,19.76377659,1128,18.3954654378,1085,19.0929145926,2213
OR,2020,6,22,12.12333062,1210,23.2570614035,1140,17.5243744894,2350
OR,2020,6,23,12.06006073,1151,25.3664948454,1164,18.7506392658,2315
OR,2020,6,24,14.87567846,1157,22.8459473684,1140,18.8313191024,2297
OR,2020,6,25,17.33929336,1203,19.438167675,1157,18.3682753865,2360
OR,2020,6,26,14.10063095,1157,20.2764797239,1159,17.1912219383,2316
OR,2020,6,27,15.62580705,1140,13.7567574692,1138,14.6921027379,2278
OR,2020,6,28,17.69200888,1110,28.0286181139,1071,22.7678953951,2181
OR,2020,6,29,14.17227956,1180,20.081684492,1122,17.0525368726,2302
OR,2020,6,30,15.43561457,1147,21.3751779359,1124,18.3753192038,2271
OR,2020,7,1,20.56149276,1226,25.5169699431,1231,23.0442735546,2457
OR,2020,7,2,16.83558779,1242,26.5411808423,1211,21.6270566796,2453
OR,2020,7,3,17.12630402,1204,24.3319325658,1216,20.7469834876,2420
OR,2020,7,4,14.02916596,1115,19.6525932203,1180,16.920514181,2295
OR,2020,7,5,22.9049587,1091,24.0703147482,1112,23.4931910766,2203
OR,2020,7,6,24.35026933,1188,22.4649776586,1119,23.4358170629,2307
OR,2020,7,7,17.08363774,1281,27.5448900169,1182,22.1040194661,2463
OR,2020,7,8,18.39483584,1249,23.7544251447,1209,21.0310211408,2458
OR,2020,7,9,20.3375356,1262,28.2635494597,1203,24.2056875972,2465
OR,2020,7,10,16.71732951,1217,27.3555484897,1258,22.1245535409,2475
OR,2020,7,11,19.54941479,1162,20.914252462,1117,20.2183589232,2279
OR,2020,7,12,11.66974278,1166,21.1947267997,1153,16.4055369045,2319
OR,2020,7,13,20.45491882,1232,22.9243407043,1221,21.6840929418,2453
OR,2020,7,14,17.95078792,1269,31.7503319502,1205,24.6720694707,2474
OR,2020,7,15,16.05432075,1266,19.3457786885,1220,17.6695977753,2486
OR,2020,7,16,17.07130566,1302,23.0957578188,1247,20.018536669,2549
OR,2020,7,17,17.81952532,1264,28.1593070866,1270,23.0016574603,2534
OR,2020,7,18,22.45634978,1189,31.9877427386,1205,27.2538971965,2394
OR,2020,7,19,20.1543099,1239,27.6114991625,1194,23.8139416219,2433
OR,2020,7,20,16.63850928,1288,33.9419316375,1258,25.188275708,2546
OR,2020,7,21,18.25985103,1342,29.0299480327,1347,23.6549126375,2689
OR,2020,7,22,19.53419263,1381,24.000015674,1276,21.678863388,2657
OR,2020,7,23,20.49953969,1412,33.5810327983,1433,27.08856592,2845
OR,2020,7,24,16.6475629,1313,26.0180334093,1317,21.3399239877,2630
OR,2020,7,25,17.50358703,1274,34.9765307692,1300,26.3283060902,2574
OR,2020,7,26,19.29095955,1261,36.5538933764,1238,27.8429851911,2499
OR,2020,7,27,21.26280923,1310,24.831616242,1256,23.0096609865,2566
OR,2020,7,28,11.36313073,1300,18.5692429022,1268,14.921288921,2568
OR,2020,7,29,13.68997727,1316,27.3269615385,1300,20.4667660884,2616
OR,2020,7,30,24.30989496,1332,21.6448137109,1342,22.9723710122,2674
OR,2020,7,31,15.14901031,1162,25.6367552776,1279,20.6442277674,2441
PA,2020,1,1,17.95416711,3770,38.4584605788,4008,28.5200205714,7778
PA,2020,1,2,13.37160727,3789,31.4603041096,3650,22.2469592615,7439
PA,2020,1,3,14.70467254,3985,32.3002564741,4016,23.53655169,8001
PA,2020,1,4,11.75253992,4197,26.1014958184,4185,18.9167466051,8382
PA,2020,1,5,14.37120395,3937,27.5331458426,4498,21.3898660286,8435
PA,2020,1,6,12.96410898,3872,34.8717539745,3837,23.8681995033,7709
PA,2020,1,7,10.85744684,3999,27.6889824121,3980,19.2531745724,7979
PA,2020,1,8,11.44545391,3966,33.528103272,3912,22.411095482,7878
PA,2020,1,9,11.5954358,4027,30.9827851662,3910,21.1462151904,7937
PA,2020,1,10,13.02070968,3875,27.3877090092,4007,20.3245115466,7882
PA,2020,1,11,13.63861197,3876,27.8183755963,3983,20.8250222669,7859
PA,2020,1,12,13.48731836,3826,27.2077483974,3744,20.2732219347,7570
PA,2020,1,13,13.14989939,4176,27.8426235647,4006,20.3436237903,8182
PA,2020,1,14,8.194957401,3288,26.2330464217,4136,18.2441944955,7424
PA,2020,1,15,13.78335486,3094,23.2678081207,2783,18.274631604,5877
PA,2020,1,16,12.74071088,3953,28.6061204819,3735,20.4484768612,7688
PA,2020,1,17,14.14674998,3920,29.8768792934,4076,22.1652601203,7996
PA,2020,1,18,11.71623306,3982,21.0312921206,3947,16.3532034361,7929
PA,2020,1,19,14.0595811,3963,25.7159327522,4015,19.9257445349,7978
PA,2020,1,20,12.59099773,3939,27.7117106653,3788,20.0036107232,7727
PA,2020,1,21,10.50522489,4046,28.816175956,4001,19.6095016658,8047
PA,2020,1,22,11.71901415,4098,30.607588368,3989,21.0360071704,8087
PA,2020,1,23,12.09493944,4045,29.9162594079,3986,20.9401369736,8031
PA,2020,1,24,12.52624097,3876,29.6944759278,3988,21.2326144455,7864
PA,2020,1,25,13.37920424,4059,24.7255178571,3920,18.9535305189,7979
PA,2020,1,26,13.10121102,4071,28.9868994109,4583,21.5139808253,8654
PA,2020,1,27,11.1148793,3894,30.8099395691,3806,20.849866233,7700
PA,2020,1,28,9.655003757,3985,28.4877637557,3962,19.0441311151,7947
PA,2020,1,29,11.54921459,4036,26.2517668024,3928,18.80079986,7964
PA,2020,1,30,13.39095238,4158,29.8565537998,3987,21.4509097601,8145
PA,2020,1,31,14.64098356,4077,33.2084889406,4295,24.1664775411,8372
PA,2020,2,1,15.86987152,4281,34.3636525892,3978,24.7775190673,8259
PA,2020,2,2,13.04704343,2760,28.9729405631,4795,23.1548762233,7555
PA,2020,2,3,15.48699399,2322,17.6383317215,2068,16.5004259783,4390
PA,2020,2,4,9.688412406,3603,19.9629865361,3268,14.5752277542,6871
PA,2020,2,5,12.10702758,3990,26.1335083984,4227,19.3225483807,8217
PA,2020,2,6,15.40428421,1886,30.1322984422,3659,25.1229143409,5545
PA,2020,2,7,8.121510977,2045,12.6395605139,1479,10.0177071362,3524
PA,2020,2,8,16.61526106,3735,28.1509183407,3833,22.4577788133,7568
PA,2020,2,9,16.34182169,3387,22.7197183476,3728,19.6836064742,7115
PA,2020,2,10,11.0060039,3586,24.5587884161,3384,17.5860071715,6970
PA,2020,2,11,8.783655663,3433,26.6033842853,3729,18.0617578736,7162
PA,2020,2,12,11.91510234,3565,31.3454816223,3156,21.0390834462,6721
PA,2020,2,13,13.70025199,4127,29.2362318113,3986,21.3332380085,8113
PA,2020,2,14,15.27825583,3784,28.7696729197,4158,22.3416293202,7942
PA,2020,2,15,14.35441052,3537,26.2173274918,3652,20.3807525399,7189
PA,2020,2,16,15.10004436,3606,25.6851136045,3565,20.3623190576,7171
PA,2020,2,17,12.78358654,3778,28.4634559221,3698,20.5396267988,7476
PA,2020,2,18,10.01644714,3918,27.0138159311,3716,18.2902514926,7634
PA,2020,2,19,9.911907963,4041,26.5864296081,4134,18.3440146885,8175
PA,2020,2,20,11.37674802,3893,31.4598451613,3875,21.3950283267,7768
PA,2020,2,21,16.89812502,3808,32.5829727646,3892,24.8261026073,7700
PA,2020,2,22,14.28536414,3721,26.4003223819,4870,21.1529984827,8591
PA,2020,2,23,14.62730133,3624,25.8731561997,3726,20.3282612272,7350
PA,2020,2,24,11.85938298,3906,30.189240967,3847,20.954567254,7753
PA,2020,2,25,10.97578962,3983,27.7815042908,3962,19.3564367598,7945
PA,2020,2,26,12.60500126,4021,31.555359199,3995,22.0494473636,8016
PA,2020,2,27,13.38955512,3956,31.3763380282,3976,22.4056228006,7932
PA,2020,2,28,15.61411839,4004,31.1135626654,4157,23.5091300127,8161
PA,2020,2,29,16.94771791,3637,27.2491884281,3906,22.2821397373,7543
PA,2020,3,1,16.13363814,3532,36.2147818599,3484,26.1055173761,7016
PA,2020,3,2,12.85360558,3808,30.9748119291,3722,21.8107277621,7530
PA,2020,3,3,12.41693222,3765,29.0275115681,3890,20.857840602,7655
PA,2020,3,4,13.41636364,3982,30.6581179775,3916,21.9652000525,7898
PA,2020,3,5,16.53576953,3983,30.0733097524,3958,23.2832300766,7941
PA,2020,3,6,18.96736366,3740,29.7353154534,3915,24.474421958,7655
PA,2020,3,7,16.99542904,3566,29.7844944126,3669,23.4809965386,7235
PA,2020,3,8,17.69247838,3466,30.0343924684,3399,23.8032090408,6865
PA,2020,3,9,12.12901274,3697,29.3478967922,3585,20.60603819,7282
PA,2020,3,10,11.40005675,4053,29.1169266409,3885,20.0710115908,7938
PA,2020,3,11,10.15615888,4569,30.77687856,4389,20.2593447112,8958
PA,2020,3,12,13.01995145,4533,28.1602107074,4651,20.6873453749,9184
PA,2020,3,13,13.74750739,4056,27.717917882,4457,21.0617467372,8513
PA,2020,3,14,10.73388334,3891,23.3129417747,3933,17.0571753676,7824
PA,2020,3,15,8.82709146,4057,20.7599822515,3944,14.7092713477,8001
PA,2020,3,16,8.326969881,4518,19.3289077341,4422,13.7688680003,8940
PA,2020,3,17,6.740508702,4600,22.7708012192,4593,14.7495518361,9193
PA,2020,3,18,6.554303727,4589,18.3154572338,4396,12.3085642519,8985
PA,2020,3,19,5.27985929,4691,20.5496799649,4562,12.8083281022,9253
PA,2020,3,20,5.4547197,4549,18.6121165978,4597,12.0679444473,9146
PA,2020,3,21,5.842120772,4305,16.1366519414,4301,10.9869939488,8606
PA,2020,3,22,5.029640693,4119,12.4475464224,4039,8.70222236019,8158
PA,2020,3,23,3.756691874,4362,15.5440871869,4152,9.50501996176,8514
PA,2020,3,24,5.687109595,4553,14.5435089348,4309,9.99338636719,8862
PA,2020,3,25,6.997757863,4518,16.3894379664,4288,11.5709493556,8806
PA,2020,3,26,6.58362315,4474,16.0780339917,4354,11.266299272,8828
PA,2020,3,27,4.772832531,4300,16.2871298613,4397,10.5941922368,8697
PA,2020,3,28,4.073658864,4116,11.957397561,4100,8.00785173859,8216
PA,2020,3,29,4.925021547,4174,15.0061553735,4029,9.8764890817,8203
PA,2020,3,30,5.683287247,4341,13.6586517389,4198,9.60418900799,8539
PA,2020,3,31,5.409583995,4399,14.6585054998,4182,9.91709940497,8581
PA,2020,4,1,5.267480151,4282,14.0515003457,4339,9.68852917371,8621
PA,2020,4,2,5.598760668,4212,13.7462962963,4131,9.63297733832,8343
PA,2020,4,3,5.097234671,4014,17.3207099143,4085,11.2625509284,8099
PA,2020,4,4,4.121225696,3859,18.3515058703,3918,11.2903446009,7777
PA,2020,4,5,5.458861706,3839,15.7371477303,3811,10.5791947829,7650
PA,2020,4,6,4.165424391,4041,12.8912944228,3855,8.42558510183,7896
PA,2020,4,7,3.28684186,4205,14.6908681429,3974,8.82781269364,8179
PA,2020,4,8,5.177439014,3854,15.4010595383,4115,10.4566708445,7969
PA,2020,4,9,4.330537165,3779,14.2847528187,3459,9.08760154,7238
PA,2020,4,10,3.696816766,3864,14.9239752024,3952,9.37359902557,7816
PA,2020,4,11,3.017723789,3642,13.3321440443,3610,8.15217733584,7252
PA,2020,4,12,3.706624561,3641,14.5087563025,3570,9.05451116719,7211
PA,2020,4,13,3.862034463,3888,13.9847082768,3685,8.78769840118,7573
PA,2020,4,14,4.670815282,3925,14.8277473684,3800,9.66710549927,7725
PA,2020,4,15,4.949281221,3979,13.057503876,3870,8.94709262051,7849
PA,2020,4,16,4.469423931,3958,13.4351678376,3843,8.88621073182,7801
PA,2020,4,17,3.785922249,3730,14.4343511053,3845,9.19096633515,7575
PA,2020,4,18,3.388848785,3631,12.3378717523,3618,7.85533589989,7249
PA,2020,4,19,4.670909571,3573,12.493881304,3589,8.59113374716,7162
PA,2020,4,20,4.00819712,3744,15.1239825423,3666,9.50758569734,7410
PA,2020,4,21,5.084115319,3781,14.0343023902,3598,9.44822604975,7379
PA,2020,4,22,4.652007952,4024,15.5102895805,3695,9.84974737645,7719
PA,2020,4,23,3.344812256,4208,15.664352743,4156,9.46628646261,8364
PA,2020,4,24,3.177229061,3728,15.161500615,4065,9.42848837924,7793
PA,2020,4,25,3.38000594,3385,15.0434863744,3376,9.2039831544,6761
PA,2020,4,26,4.384250356,3315,11.8281610897,3377,8.14068887181,6692
PA,2020,4,27,3.970835717,3458,12.81752443,3377,8.34176004526,6835
PA,2020,4,28,3.634945376,3569,14.7560337798,3434,9.08829645108,7003
PA,2020,4,29,5.287904253,3655,17.6321681291,3533,11.3552782477,7188
PA,2020,4,30,5.08643347,3774,18.8919343267,3624,11.849225455,7398
PA,2020,5,1,5.576163965,3488,20.7811164274,3762,13.4659613669,7250
PA,2020,5,2,5.620967045,3309,18.7132813905,3337,12.1947035739,6646
PA,2020,5,3,5.676060966,3313,15.7326656489,3275,10.675359742,6588
PA,2020,5,4,4.625461462,3565,15.3081446071,3347,9.79834058334,6912
PA,2020,5,5,3.845923553,3584,16.9193482573,3529,10.3320919463,7113
PA,2020,5,6,4.703665015,3618,15.9467893073,3479,10.215124704,7097
PA,2020,5,7,4.681752463,3652,17.3640868095,3548,10.9313249993,7200
PA,2020,5,8,4.212312392,3438,16.2252446024,3659,10.4058193608,7097
PA,2020,5,9,5.495474278,3363,18.0559148936,3290,11.7067849086,6653
PA,2020,5,10,7.060683022,3221,13.3874441088,3310,10.2671719513,6531
PA,2020,5,11,5.417553543,3409,17.2822304833,3228,11.1881090897,6637
PA,2020,5,12,5.340782549,3463,15.590751228,3461,10.4642865348,6924
PA,2020,5,13,5.615800461,3167,17.3081622419,3390,11.6608067805,6557
PA,2020,5,14,4.844147937,3245,15.2179314976,2978,9.80849430428,6223
PA,2020,5,15,6.343468194,3411,20.4998792135,3560,13.5729651427,6971
PA,2020,5,16,5.559460472,3262,16.544763524,3235,11.0292858334,6497
PA,2020,5,17,6.040588427,3195,17.4020365778,3226,11.748738518,6421
PA,2020,5,18,4.611463855,3361,19.578453735,3253,11.9727608129,6614
PA,2020,5,19,4.353889849,3414,18.719477657,3312,11.4277564592,6726
PA,2020,5,20,6.169503693,3506,16.5687988338,3430,11.3121770397,6936
PA,2020,5,21,6.142034037,3525,19.0530083234,3364,12.4466526318,6889
PA,2020,5,22,5.599325797,3278,23.9597495019,3513,15.0972154267,6791
PA,2020,5,23,6.798821026,3062,16.7656810094,3091,11.8057386611,6153
PA,2020,5,24,6.581073913,3017,16.7290936658,2968,11.6135421881,5985
PA,2020,5,25,6.331948805,3125,17.266,3075,11.7548854864,6200
PA,2020,5,26,6.416610853,3284,18.8458116985,3197,12.5477873849,6481
PA,2020,5,27,5.918395748,3497,16.8923148706,3322,11.264540245,6819
PA,2020,5,28,6.121382971,3666,19.5769594595,3552,12.7429135455,7218
PA,2020,5,29,6.958477633,3580,17.2088325694,3709,12.1743599844,7289
PA,2020,5,30,6.33165917,3556,17.8180759703,3633,12.1363819736,7189
PA,2020,5,31,10.35281504,3531,17.5974171829,3713,14.0661236756,7244
PA,2020,6,1,7.146749736,3772,22.8363283504,3813,15.0339433097,7585
PA,2020,6,2,4.329385498,3694,17.1853294828,3809,10.8558803185,7503
PA,2020,6,3,4.492960398,3513,16.9803052404,3702,10.9001884793,7215
PA,2020,6,4,6.368304154,3426,16.6943683901,3404,11.5147057147,6830
PA,2020,6,5,7.005871709,3212,20.4918841411,3487,14.02568442,6699
PA,2020,6,6,9.016275628,2975,23.4082667934,3156,16.4247121176,6131
PA,2020,6,7,8.866162155,2874,18.3676021986,2911,13.6472670758,5785
PA,2020,6,8,8.411806491,3039,21.3904537815,2975,14.8320718201,6014
PA,2020,6,9,5.018456817,3266,19.6030818009,3154,12.1835513963,6420
PA,2020,6,10,7.433843535,3260,18.3834400732,3279,12.9245496137,6539
PA,2020,6,11,7.421264747,3305,22.2499305346,3311,14.8423216428,6616
PA,2020,6,12,8.841952314,2935,27.2440444986,3281,18.5551544468,6216
PA,2020,6,13,7.144679368,2885,25.5936753927,2865,16.3370921699,5750
PA,2020,6,14,7.405126631,3080,18.7317075533,3098,13.0849174528,6178
PA,2020,6,15,5.916895892,3141,18.930197013,3147,12.4297550885,6288
PA,2020,6,16,6.396573934,3199,22.7076161872,3163,14.5059462457,6362
PA,2020,6,17,6.510089203,3363,17.6494378966,3309,12.0346852503,6672
PA,2020,6,18,8.493609401,3405,22.9813217031,3382,15.7129173435,6787
PA,2020,6,19,11.78070927,3144,23.2563457463,3303,17.6600372181,6447
PA,2020,6,20,11.57563382,3037,19.6683676178,3014,15.6066203787,6051
PA,2020,6,21,11.42414828,2994,23.6527724092,3001,17.5455996581,5995
PA,2020,6,22,7.857142864,3255,19.5489911851,3063,13.5254131089,6318
PA,2020,6,23,7.971440367,3270,21.6482007862,3307,14.8482910142,6577
PA,2020,6,24,9.617134329,3186,21.2088766172,3169,15.3975011758,6355
PA,2020,6,25,10.39994909,3145,23.7176889715,3228,17.1455421133,6373
PA,2020,6,26,9.204510692,3086,23.8400687715,3199,16.6538583923,6285
PA,2020,6,27,9.366982289,2999,22.7029472999,3074,16.1173126766,6073
PA,2020,6,28,10.50975142,3017,27.2552499204,3141,19.0510977646,6158
PA,2020,6,29,8.158451838,3249,24.1042244641,3172,16.0357280831,6421
PA,2020,6,30,6.875949971,3079,24.28642448,3317,15.9051156912,6396
PA,2020,7,1,10.87582308,3177,27.9889119804,3272,19.5584136959,6449
PA,2020,7,2,10.91559873,3165,27.1803269412,3181,19.0684667476,6346
PA,2020,7,3,12.22304296,3099,22.8900252924,3163,17.611044416,6262
PA,2020,7,4,11.38377253,2884,30.5573522907,3165,21.4159067576,6049
PA,2020,7,5,12.49931693,2928,19.659756871,2838,16.0236541747,5766
PA,2020,7,6,9.211528572,3186,21.278847512,3115,15.1772004492,6301
PA,2020,7,7,9.163473959,3224,21.278209799,3184,15.1830305936,6408
PA,2020,7,8,7.870297991,3255,25.6213149847,3270,16.7662099557,6525
PA,2020,7,9,7.368414107,3323,31.1927010622,3295,19.2301586699,6618
PA,2020,7,10,10.1032579,3091,24.2500208024,3365,17.4768417238,6456
PA,2020,7,11,9.161809569,2962,22.8002395013,3048,16.0786039839,6010
PA,2020,7,12,13.78125927,2986,23.283249833,2994,18.538610398,5980
PA,2020,7,13,9.045195391,3251,21.577712294,3156,15.2185406924,6407
PA,2020,7,14,7.898012485,3361,23.5594524762,3251,15.5984573445,6612
PA,2020,7,15,8.318169849,3344,21.5232149201,3378,14.9540880653,6722
PA,2020,7,16,8.378158445,3269,24.6739235901,3298,16.5620222258,6567
PA,2020,7,17,9.84532501,3108,28.5323757576,3300,19.4688062002,6408
PA,2020,7,18,8.660440805,3040,24.3632425505,3121,16.6150657437,6161
PA,2020,7,19,9.60458592,3055,27.3675608942,2997,18.4009567061,6052
PA,2020,7,20,7.816935561,3273,24.76988117,3282,16.3050465433,6555
PA,2020,7,21,6.245229772,3373,21.9953546208,3257,13.9825082988,6630
PA,2020,7,22,8.116082652,3556,22.4976078089,3432,15.1792472682,6988
PA,2020,7,23,11.13080135,3594,23.9218387631,3622,17.5511363708,7216
PA,2020,7,24,11.7627313,3156,24.698046176,3465,18.5322322886,6621
PA,2020,7,25,9.29402341,2985,23.8637844941,3044,16.6501940419,6029
PA,2020,7,26,11.02150295,3014,21.5261504871,2977,16.2413887316,5991
PA,2020,7,27,9.044942413,3298,22.3122748966,3143,15.5189722214,6441
PA,2020,7,28,7.06901278,3363,24.2485667559,3363,15.6587897679,6726
PA,2020,7,29,7.066249993,3384,22.3213416111,3302,14.6002482764,6686
PA,2020,7,30,9.982855899,3295,25.4462188612,3372,17.8038338364,6667
PA,2020,7,31,10.63141713,2992,26.7077936164,3227,18.9733478136,6219
RI,2020,1,1,9.719925012,400,14.3437817259,394,12.0143828776,794
RI,2020,1,2,11.38501208,415,11.0967428571,350,11.2531242003,765
RI,2020,1,3,17.25038446,442,24.9187131367,373,20.759938566,815
RI,2020,1,4,12.94598132,428,10.9589761905,420,11.9618514209,848
RI,2020,1,5,7.523454104,414,20.8759,400,14.0848525787,814
RI,2020,1,6,13.44867782,416,7.57166226913,379,10.6469307838,795
RI,2020,1,7,7.95285044,421,10.4917435897,390,9.17377316306,811
RI,2020,1,8,16.18736081,413,13.7336567164,402,14.9770675025,815
RI,2020,1,9,8.858481303,428,19.0248947368,380,13.6397153437,808
RI,2020,1,10,10.20164526,389,21.71275,400,16.037439805,789
RI,2020,1,11,11.92721815,399,16.3504774536,377,14.0761469611,776
RI,2020,1,12,18.69778355,397,37.6221079692,389,28.0636387651,786
RI,2020,1,13,8.740208325,384,13.1482872928,362,10.8792493255,746
RI,2020,1,14,7.833364098,324,14.1145990566,424,11.3938502243,748
RI,2020,1,15,18.69072342,318,6.4524535316,269,13.0823850895,587
RI,2020,1,16,6.828578792,387,24.168559322,354,15.1124561302,741
RI,2020,1,17,16.63982611,403,11.1888308458,402,13.9177141892,805
RI,2020,1,18,12.97656426,390,7.4193442623,366,10.2861641024,756
RI,2020,1,19,6.897506725,369,15.9140607735,362,11.3626128338,731
RI,2020,1,20,10.19890381,374,31.8804899135,347,20.6337309639,721
RI,2020,1,21,10.7680669,388,29.1852717391,368,19.7330554989,756
RI,2020,1,22,12.60895893,413,6.47152849741,386,9.64394247571,799
RI,2020,1,23,11.19815908,402,29.8344892473,372,20.1551549744,774
RI,2020,1,24,12.64936105,407,17.3110824742,388,14.924515657,795
RI,2020,1,25,20.64250634,399,6.3752688172,372,13.7587030216,771
RI,2020,1,26,11.33725006,400,16.1091647332,431,13.8122142286,831
RI,2020,1,27,13.0218864,387,18.0454492754,345,15.3895492306,732
RI,2020,1,28,6.642055915,394,14.399,370,10.3986911394,764
RI,2020,1,29,11.91658612,413,24.8273015873,378,18.0863085557,791
RI,2020,1,30,13.59954349,438,13.4857831325,415,13.5441970089,853
RI,2020,1,31,18.11390117,446,18.0826530612,441,18.0983651881,887
RI,2020,2,1,11.36615538,476,13.0600243902,410,12.1499999558,886
RI,2020,2,2,9.975944872,291,9.7487704918,488,9.83363280841,779
RI,2020,2,3,10.95463826,235,13.738226601,203,12.2447488381,438
RI,2020,2,4,12.99732129,392,13.0600278552,359,13.0272968651,751
RI,2020,2,5,12.73865142,430,9.89902173913,460,11.2709776524,890
RI,2020,2,6,12.35654245,188,16.3701634877,367,15.0105945596,555
RI,2020,2,7,5.066225474,204,1.64352201258,159,3.56702478429,363
RI,2020,2,8,15.40569668,409,19.8279840849,377,17.5268192648,786
RI,2020,2,9,10.24472864,387,24.3477071823,362,17.0608544508,749
RI,2020,2,10,6.841862233,392,8.94758308157,331,7.80589210973,723
RI,2020,2,11,11.10736981,365,10.158680203,394,10.6149011603,759
RI,2020,2,12,5.754557309,384,13.733148688,343,9.51887208618,727
RI,2020,2,13,13.2117743,434,12.6599761905,420,12.9403981806,854
RI,2020,2,14,13.37155019,387,17.9064,400,15.6764293819,787
RI,2020,2,15,12.54185857,382,26.1750670241,373,19.2772052632,755
RI,2020,2,16,13.42930512,403,27.0222535211,355,19.79539573,758
RI,2020,2,17,11.36744415,403,27.9088828338,367,19.2514805097,770
RI,2020,2,18,6.502808177,438,15.6876130653,398,10.8754784468,836
RI,2020,2,19,14.66095907,438,15.4004148472,458,15.0389398132,896
RI,2020,2,20,14.6386132,411,38.787464455,422,26.8724850242,833
RI,2020,2,21,13.10061698,389,38.4209160305,393,25.8255243034,782
RI,2020,2,22,14.56233259,373,13.187464503,493,13.7796420971,866
RI,2020,2,23,19.95137646,385,11.5339169139,337,16.0224514364,722
RI,2020,2,24,7.764187842,394,14.5487252125,353,10.9702677507,747
RI,2020,2,25,16.62669115,411,10.0301081081,370,13.501549376,781
RI,2020,2,26,12.07993011,430,4.80274406332,379,8.67071686934,809
RI,2020,2,27,8.307736357,402,18.1498666667,375,13.0577992478,777
RI,2020,2,28,17.38210403,423,28.3438419619,367,22.4744557021,790
RI,2020,2,29,10.81647783,406,16.2283541147,401,13.5056505564,807
RI,2020,3,1,17.66050647,395,15.2778712871,404,16.4557697818,799
RI,2020,3,2,10.72262467,381,15.6069589041,365,13.1124128677,746
RI,2020,3,3,14.89995252,421,8.87504021448,373,12.0696095855,794
RI,2020,3,4,11.35663565,431,11.623381295,417,11.4878065627,848
RI,2020,3,5,12.9136364,418,14.7438694639,429,13.8406375622,847
RI,2020,3,6,13.81111392,386,16.1010880829,386,14.9561010015,772
RI,2020,3,7,12.49331344,335,14.2109195402,348,13.3684626682,683
RI,2020,3,8,13.66676885,359,35.8276162791,344,24.510768161,703
RI,2020,3,9,12.16203555,393,18.9833731343,335,15.3009752351,728
RI,2020,3,10,9.38186924,444,4.91050666667,375,7.33454205441,819
RI,2020,3,11,11.19598329,478,20.226,425,15.4459911546,903
RI,2020,3,12,9.4266333,499,12.9868607069,481,11.1740510374,980
RI,2020,3,13,8.963220048,441,11.4038372093,430,10.168117154,871
RI,2020,3,14,5.323071443,420,4.50277777778,396,4.92498775252,816
RI,2020,3,15,11.28108222,462,5.08220183486,436,8.27138083033,898
RI,2020,3,16,6.813989043,539,15.2211293634,487,10.8045127624,1026
RI,2020,3,17,7.260730997,561,12.5610714286,560,9.90853710019,1121
RI,2020,3,18,6.374505543,526,2.20172131148,488,4.36630169193,1014
RI,2020,3,19,2.381541203,558,2.7819488189,508,2.57235458844,1066
RI,2020,3,20,5.60888468,529,7.09046040516,543,6.35934701093,1072
RI,2020,3,21,5.054989769,489,12.3224017467,458,8.56974656499,947
RI,2020,3,22,1.967768931,502,4.50152263374,486,3.21412955806,988
RI,2020,3,23,4.388774291,514,4.17676767677,495,4.28476708184,1009
RI,2020,3,24,3.869643509,533,4.35813121272,503,4.10681466245,1036
RI,2020,3,25,6.491919422,521,4.21508032129,498,5.37919530801,1019
RI,2020,3,26,2.988552643,532,7.9826284585,506,5.42304432185,1038
RI,2020,3,27,3.169061197,490,8.48130977131,481,5.80056641249,971
RI,2020,3,28,2.09995787,475,11.8917826087,460,6.91732619064,935
RI,2020,3,29,4.723707661,472,7.37631130064,469,6.04578110095,941
RI,2020,3,30,3.870694735,475,11.4520086393,463,7.61285714192,938
RI,2020,3,31,6.040796731,502,8.11322147651,447,7.0169546459,949
RI,2020,4,1,3.765236169,508,2.99874509804,510,3.38123769534,1018
RI,2020,4,2,3.221827163,509,2.88779874214,477,3.06023329206,986
RI,2020,4,3,4.149052675,475,8.07150943396,477,6.11440128217,952
RI,2020,4,4,3.446359615,456,4.95744730679,427,4.1770894501,883
RI,2020,4,5,7.106210199,438,6.15301176471,425,6.63679034434,863
RI,2020,4,6,3.117762837,447,2.69748730964,394,2.92086800017,841
RI,2020,4,7,2.653728789,472,8.91957845433,427,5.62983313505,899
RI,2020,4,8,2.96079443,428,1.80997695853,434,2.38138052905,862
RI,2020,4,9,1.518755992,418,4.42735897436,390,2.92266089685,808
RI,2020,4,10,1.85380842,428,8.53346987952,415,5.14213523578,843
RI,2020,4,11,3.879975252,404,6.96652061856,388,5.39207070935,792
RI,2020,4,12,5.152468549,397,12.9495696203,395,9.04117426004,792
RI,2020,4,13,8.961261491,436,3.77045130641,421,6.41128355902,857
RI,2020,4,14,3.798434507,428,3.40596354167,384,3.61283247413,812
RI,2020,4,15,2.228474158,426,10.7184951456,412,6.40256562209,838
RI,2020,4,16,2.476590947,440,4.6669,400,3.51959525795,840
RI,2020,4,17,1.504769991,413,6.50782926829,410,3.99718105259,823
RI,2020,4,18,0.925037404,401,2.31466666667,420,1.63593178929,821
RI,2020,4,19,4.949004875,412,15.9154317549,359,10.0552918398,771
RI,2020,4,20,2.74721264,409,10.1640102828,389,6.36266913504,798
RI,2020,4,21,4.856876419,429,4.12178756477,386,4.50872390644,815
RI,2020,4,22,1.906855198,442,16.8382309582,407,9.0647703151,849
RI,2020,4,23,5.615406616,455,1.72844868735,419,3.7519794168,874
RI,2020,4,24,3.341089078,404,1.698640553,434,2.49046537889,838
RI,2020,4,25,8.525192854,337,2.664,360,5.49789094949,697
RI,2020,4,26,1.730504449,337,17.6543202417,331,9.62089820256,668
RI,2020,4,27,4.713844054,372,2.18761363636,352,3.48562153051,724
RI,2020,4,28,2.664430418,395,2.28449152542,354,2.48485983326,749
RI,2020,4,29,3.241287137,404,5.2143943662,355,4.16415020204,759
RI,2020,4,30,5.654899582,398,22.5112711864,354,13.5899468532,752
RI,2020,5,1,5.851409274,369,8.13055979644,393,7.02687666943,762
RI,2020,5,2,4.811159462,345,1.83125364431,343,3.32553781161,688
RI,2020,5,3,4.331976427,339,7.41263157895,323,5.83507554192,662
RI,2020,5,4,2.139872119,391,4.11113960114,351,3.07237196567,742
RI,2020,5,5,1.207208751,412,1.93830555556,360,1.54813472204,772
RI,2020,5,6,3.642063825,407,3.00396782842,373,3.33692304715,780
RI,2020,5,7,1.670997446,391,16.4605076142,394,9.09401274062,785
RI,2020,5,8,4.936121885,361,11.2678514589,377,8.17062330689,738
RI,2020,5,9,4.17768572,350,4.52922413793,348,4.35295129226,698
RI,2020,5,10,2.733693674,333,2.85871428571,350,2.79775987327,683
RI,2020,5,11,2.792744082,379,7.50815864023,353,5.06670765994,732
RI,2020,5,12,3.445633138,387,2.42065714286,350,2.95887384587,737
RI,2020,5,13,6.390293217,341,5.37374639769,347,5.8775871904,688
RI,2020,5,14,1.327167629,346,3.91137931034,319,2.56681202952,665
RI,2020,5,15,3.563183027,377,11.1988088643,361,7.29822493385,738
RI,2020,5,16,3.415083333,360,7.45371657754,374,5.47291553117,734
RI,2020,5,17,3.769550604,356,3.12481481481,324,3.46235296327,680
RI,2020,5,18,4.054956086,341,10.1207012195,328,7.02889390931,669
RI,2020,5,19,4.218365657,361,8.93849529781,319,6.43266176791,680
RI,2020,5,20,2.565699202,379,7.52569148936,376,5.03584105637,755
RI,2020,5,21,5.876898443,374,4.87404011461,349,5.39280776996,723
RI,2020,5,22,7.843519952,375,12.4141803279,366,10.1010930931,741
RI,2020,5,23,6.230698986,329,3.24985795455,352,4.6899412135,681
RI,2020,5,24,8.743822679,327,3.77321981424,323,6.27381540928,650
RI,2020,5,25,3.960112666,355,8.48120743034,323,6.11396754636,678
RI,2020,5,26,3.498310235,361,4.61083815029,346,4.04277226992,707
RI,2020,5,27,5.56966947,363,11.4467741935,341,8.41639207047,704
RI,2020,5,28,5.35642854,392,2.11034285714,350,3.82525604809,742
RI,2020,5,29,8.866491684,362,6.51607792208,385,7.65510038769,747
RI,2020,5,30,3.438446327,354,10.7833602151,372,7.20195592253,726
RI,2020,5,31,3.694630188,365,8.12836858006,331,5.80320404974,696
RI,2020,6,1,8.328501482,387,4.27420485175,371,6.34414257722,758
RI,2020,6,2,2.132987001,385,3.59866983373,421,2.89856078832,806
RI,2020,6,3,4.343297245,370,10.423625731,342,7.26390446721,712
RI,2020,6,4,3.040620169,387,15.1067055394,343,8.71002740466,730
RI,2020,6,5,4.416759497,395,8.84945754717,424,6.71158730319,819
RI,2020,6,6,3.291852942,340,10.6940860215,372,7.15931179815,712
RI,2020,6,7,7.094670826,319,6.57418803419,351,6.82199999029,670
RI,2020,6,8,8.54331223,317,17.4068987342,316,12.9681042289,633
RI,2020,6,9,2.545335468,313,4.74070769231,325,3.66366771392,638
RI,2020,6,10,4.819327481,342,4.22637462236,331,4.52769687742,673
RI,2020,6,11,8.3832786,366,13.2261976048,334,10.6940428109,700
RI,2020,6,12,14.14825961,339,10.333641791,335,12.2522700412,674
RI,2020,6,13,5.780338423,325,16.9470774648,284,10.9878160714,609
RI,2020,6,14,12.82312866,326,11.8006990881,329,12.3095724323,655
RI,2020,6,15,4.229938616,326,11.4405970149,335,7.88435701788,661
RI,2020,6,16,6.465373556,348,6.88484375,320,6.66631736151,668
RI,2020,6,17,10.04628256,347,7.71514619883,342,8.88917278421,689
RI,2020,6,18,3.902195855,337,7.77780487805,328,5.8137744408,665
RI,2020,6,19,8.871510527,331,5.41307692308,351,7.09158355489,682
RI,2020,6,20,8.024588284,340,18.4414596273,322,13.0914048589,662
RI,2020,6,21,6.362500025,308,23.1704191617,334,15.1068068656,642
RI,2020,6,22,6.208422755,317,10.6233647799,318,8.41937009974,635
RI,2020,6,23,7.953256502,347,12.1212280702,342,10.0221190221,689
RI,2020,6,24,3.66902506,359,9.04504918033,305,6.13843372973,664
RI,2020,6,25,4.610623202,353,5.43485119048,336,5.01256892642,689
RI,2020,6,26,10.70996931,325,13.4932817337,323,12.0973302867,648
RI,2020,6,27,6.955030994,322,12.9940860215,279,9.75851910161,601
RI,2020,6,28,12.82966688,360,10.1945238095,336,11.557528846,696
RI,2020,6,29,6.890087152,344,10.9177477477,333,8.87119642583,677
RI,2020,6,30,5.402386792,331,5.58473520249,321,5.49216261987,652
RI,2020,7,1,5.532553837,325,15.5243023256,344,10.6703138969,669
RI,2020,7,2,7.283929674,313,22.6380463576,302,14.8236747772,615
RI,2020,7,3,9.668787786,330,9.75700325733,307,9.71130293466,637
RI,2020,7,4,5.964373052,327,19.2348126801,347,12.7964836617,674
RI,2020,7,5,8.545670635,328,17.5214137931,290,12.7575889454,618
RI,2020,7,6,7.096978804,331,10.5835849057,371,8.939615362,702
RI,2020,7,7,10.08663708,339,7.57294670846,319,8.86799387556,658
RI,2020,7,8,10.94227283,374,7.65834890966,321,9.42552523514,695
RI,2020,7,9,6.322131136,366,6.56793103448,348,6.44193276719,714
RI,2020,7,10,9.555799988,350,8.99025139665,358,9.26983050254,708
RI,2020,7,11,6.829274493,317,11.6387878788,330,9.28234932655,647
RI,2020,7,12,5.760000041,318,8.79169381107,307,7.24916802086,625
RI,2020,7,13,4.42197636,339,33.5190963855,332,18.8187630194,671
RI,2020,7,14,3.943163831,354,5.0609439528,339,4.48995670444,693
RI,2020,7,15,9.05861399,368,9.90614243323,337,9.46374460755,705
RI,2020,7,16,9.920819072,354,10.3826553672,354,10.1517372196,708
RI,2020,7,17,11.13693488,323,5.94525835866,329,8.51720853718,652
RI,2020,7,18,8.546590237,305,7.28718032787,305,7.91688528243,610
RI,2020,7,19,7.115281181,320,8.86792207792,308,7.97485665274,628
RI,2020,7,20,5.070846982,366,9.89449275362,345,7.4114345927,711
RI,2020,7,21,5.982506572,375,8.39688888889,360,7.16506117619,735
RI,2020,7,22,7.78023539,382,6.39267409471,359,7.10798909444,741
RI,2020,7,23,6.088253912,378,4.16751515152,330,5.19299432025,708
RI,2020,7,24,6.941913035,345,11.8651578947,380,9.52237240976,725
RI,2020,7,25,10.56283384,307,21.9142121212,330,16.4434536717,637
RI,2020,7,26,6.775926974,356,12.4422910217,323,9.47141384793,679
RI,2020,7,27,4.485755972,377,10.8429059829,351,7.55081044154,728
RI,2020,7,28,7.313440552,404,5.93005633803,355,6.66640313967,759
RI,2020,7,29,4.632230975,381,8.2240625,352,6.35709413571,733
RI,2020,7,30,6.786621989,373,4.91523415978,363,5.86364130693,736
RI,2020,7,31,10.12969191,357,9.06266666667,345,9.60529916221,702
SC,2020,1,1,28.80478037,1207,31.6527419355,1364,30.3157175833,2571
SC,2020,1,2,27.7555585,1164,25.5723599321,1178,26.6574338574,2342
SC,2020,1,3,27.49416668,1224,32.0374,1250,29.7896564334,2474
SC,2020,1,4,21.18668556,1237,26.8445612708,1322,24.1095896982,2559
SC,2020,1,5,24.72596094,1129,28.780204918,1220,26.8316134105,2349
SC,2020,1,6,17.00522179,1195,30.1830346051,1127,23.4011714208,2322
SC,2020,1,7,16.23281602,1218,22.9196434494,1206,19.5596781817,2424
SC,2020,1,8,23.78686976,1214,33.6206275469,1227,28.7299344075,2441
SC,2020,1,9,24.52631619,1265,31.2961965135,1262,27.9072378236,2527
SC,2020,1,10,27.18303257,1164,25.8137385321,1308,26.4585032004,2472
SC,2020,1,11,20.512375,1120,27.9630534979,1215,24.3892805139,2335
SC,2020,1,12,22.49267729,1214,27.8259515571,1156,25.0940549494,2370
SC,2020,1,13,17.07041124,1386,23.8021473245,1439,20.4994265411,2825
SC,2020,1,14,21.05256033,1035,25.5265649397,1409,23.6318862281,2444
SC,2020,1,15,23.59626059,944,25.1788591385,859,24.3502551287,1803
SC,2020,1,16,20.86748164,1223,27.2099417637,1202,24.0112495034,2425
SC,2020,1,17,25.07888522,1211,34.5450154083,1298,29.976070148,2509
SC,2020,1,18,21.33404361,1192,25.5592539816,1193,23.4475345841,2385
SC,2020,1,19,27.75404131,1210,24.1388085782,1259,25.9105508243,2469
SC,2020,1,20,21.507357,1188,26.9785631709,1211,24.2691872097,2399
SC,2020,1,21,15.53707171,1185,28.1397012448,1205,21.8911171449,2390
SC,2020,1,22,21.58499137,1166,29.6535166667,1200,25.6772273615,2366
SC,2020,1,23,21.92536743,1211,24.6980287648,1182,23.2948976004,2393
SC,2020,1,24,19.88773514,1148,37.7908757962,1256,29.2414558822,2404
SC,2020,1,25,21.59276855,1210,29.1563263598,1195,25.3509604763,2405
SC,2020,1,26,23.55014754,1153,24.5940732601,1365,24.1160564391,2518
SC,2020,1,27,17.70226183,1176,27.493998227,1128,22.4961327743,2304
SC,2020,1,28,14.64690222,1246,26.6726492232,1223,20.6037627242,2469
SC,2020,1,29,16.16152971,1216,24.8585849802,1265,20.5959412041,2481
SC,2020,1,30,19.56464681,1246,29.335249584,1202,24.3621404923,2448
SC,2020,1,31,25.04973637,1214,24.8643722304,1354,24.9520015394,2568
SC,2020,2,1,24.25031513,1238,35.6769356153,1227,29.9381298706,2465
SC,2020,2,2,21.75619623,815,28.9623148148,1404,26.3156331354,2219
SC,2020,2,3,17.79288037,677,14.3869701727,637,16.1417656092,1314
SC,2020,2,4,13.24174395,1078,21.6136582915,995,17.2601012919,2073
SC,2020,2,5,19.49276929,1300,26.2083428165,1406,22.9820879812,2706
SC,2020,2,6,22.80313164,562,22.5160194175,1236,22.6057619475,1798
SC,2020,2,7,13.92505807,603,14.5593905192,443,14.1937093845,1046
SC,2020,2,8,21.06641731,1217,28.0447809948,1347,24.7325077482,2564
SC,2020,2,9,20.65861903,1079,28.0510234899,1192,24.5387362102,2271
SC,2020,2,10,12.21266299,1104,29.3798623064,1162,21.0159664347,2266
SC,2020,2,11,15.39828288,1025,33.9370157938,1203,25.408200158,2228
SC,2020,2,12,21.66144513,1121,25.7244094488,1016,23.5931118347,2137
SC,2020,2,13,28.118749,1263,23.5592259084,1266,25.8362831107,2529
SC,2020,2,14,27.14820892,1206,33.6650597907,1338,30.5757035997,2544
SC,2020,2,15,23.76720743,1128,30.1644717445,1221,27.092477642,2349
SC,2020,2,16,33.06324462,1128,29.498260497,1167,31.2504618437,2295
SC,2020,2,17,21.14189577,1171,28.4846937086,1208,24.8703951016,2379
SC,2020,2,18,17.44932693,1233,22.330542571,1198,19.8547964232,2431
SC,2020,2,19,21.15522269,1258,26.3654781943,1307,23.8101170152,2565
SC,2020,2,20,25.89269209,1185,23.0473933649,1266,24.4230273875,2451
SC,2020,2,21,26.71529853,1172,28.2526638298,1175,27.4849637312,2347
SC,2020,2,22,28.96538532,1155,33.5258281445,1606,31.6180731781,2761
SC,2020,2,23,33.03764273,1103,34.4847909408,1148,33.7756818886,2251
SC,2020,2,24,23.89822709,1207,33.7907166392,1214,28.8587732745,2421
SC,2020,2,25,22.94087775,1219,32.4888700999,1301,27.8702182449,2520
SC,2020,2,26,27.23381649,1221,33.1524863174,1279,30.2618079737,2500
SC,2020,2,27,27.91498793,1245,29.5080562448,1209,28.6998369898,2454
SC,2020,2,28,26.73491152,1301,38.6165338924,1431,32.958411379,2732
SC,2020,2,29,30.61191002,1246,34.925936255,1506,32.972710714,2752
SC,2020,3,1,29.52529308,1126,44.521043627,1169,37.1636514196,2295
SC,2020,3,2,24.60311507,1130,29.1332957502,1153,26.8910249799,2283
SC,2020,3,3,18.07259105,1181,30.4322596549,1217,24.3452001793,2398
SC,2020,3,4,22.28287943,1219,28.1295585875,1246,25.2382393611,2465
SC,2020,3,5,27.79756114,1267,28.5494884093,1251,28.1711358079,2518
SC,2020,3,6,31.74116736,1242,34.1713842663,1322,32.9941887134,2564
SC,2020,3,7,28.5964013,1206,31.8965297907,1242,30.270731196,2448
SC,2020,3,8,28.71353955,1099,34.9886326194,1214,32.0070816971,2313
SC,2020,3,9,22.52108529,1161,36.0301811907,1159,29.2698103542,2320
SC,2020,3,10,22.17432336,1212,26.0264888124,1162,24.0598398957,2374
SC,2020,3,11,20.64753744,1401,26.7203023256,1290,23.5586733383,2691
SC,2020,3,12,22.45371826,1412,30.7404911323,1466,26.6748471797,2878
SC,2020,3,13,28.59433363,1283,31.0053690808,1436,29.8676866669,2719
SC,2020,3,14,24.47457585,1167,34.620673788,1217,29.6540226581,2384
SC,2020,3,15,26.52297272,1174,32.6230300569,1231,29.6452889702,2405
SC,2020,3,16,17.91506389,1329,22.9892325764,1277,20.4015233729,2606
SC,2020,3,17,14.70197062,1360,22.6171653005,1464,18.8053151711,2824
SC,2020,3,18,13.39579583,1401,17.0375806452,1364,15.1923218654,2765
SC,2020,3,19,11.01984964,1396,18.616676449,1363,14.7728307711,2759
SC,2020,3,20,12.26426053,1305,23.7131459075,1405,18.1999372663,2710
SC,2020,3,21,14.56513224,1286,16.8372484277,1272,15.6949726586,2558
SC,2020,3,22,12.44854398,1195,20.0135298935,1221,16.2717425729,2416
SC,2020,3,23,7.737580647,1302,18.4261089187,1267,13.0090346448,2569
SC,2020,3,24,6.390377615,1324,20.4361901358,1399,13.6067168425,2723
SC,2020,3,25,10.50869016,1420,20.6562924668,1354,15.4617736219,2774
SC,2020,3,26,8.694071687,1422,18.8087437186,1393,13.6993072607,2815
SC,2020,3,27,6.20614746,1316,17.3487446198,1394,11.9378007592,2710
SC,2020,3,28,9.129297928,1239,17.3129361371,1284,13.2940983483,2523
SC,2020,3,29,8.500255132,1176,21.6322653722,1236,15.2295937128,2412
SC,2020,3,30,8.028767098,1241,17.5632905297,1246,12.805613176,2487
SC,2020,3,31,12.27596771,1302,21.4898358092,1279,16.8418481048,2581
SC,2020,4,1,8.695323498,1283,19.4350641509,1325,14.1516717975,2608
SC,2020,4,2,8.567979797,1292,17.4203243671,1264,12.9456650617,2556
SC,2020,4,3,9.064335262,1181,21.3172692308,1300,15.4846553585,2481
SC,2020,4,4,8.0380722,1136,23.6524576271,1180,15.9935880912,2316
SC,2020,4,5,9.230999082,1101,15.4954195205,1168,12.4556985409,2269
SC,2020,4,6,5.936237353,1188,22.4583083333,1200,14.2387855843,2388
SC,2020,4,7,4.754271765,1229,15.7215310234,1241,10.2645425098,2470
SC,2020,4,8,10.00839885,1118,15.7155815769,1281,13.0558774132,2399
SC,2020,4,9,8.514287046,1059,20.7641482194,1039,14.5808293526,2098
SC,2020,4,10,9.342955524,1103,17.0278100264,1137,13.2437053317,2240
SC,2020,4,11,6.675960482,1062,17.6328623853,1090,12.225692394,2152
SC,2020,4,12,5.790237895,1093,13.3930217786,1102,9.60721640967,2195
SC,2020,4,13,6.760624968,1168,21.5900665004,1203,14.2847996468,2371
SC,2020,4,14,7.560180696,1162,20.3017986231,1162,13.9309896595,2324
SC,2020,4,15,7.950147043,1156,18.1697760551,1161,13.0709883391,2317
SC,2020,4,16,10.05829874,1158,15.8748829141,1153,12.9602985465,2311
SC,2020,4,17,6.650909874,1099,19.3276387738,1207,13.2861274725,2306
SC,2020,4,18,7.071030088,1029,18.9621122995,1122,13.273630851,2151
SC,2020,4,19,9.126106732,1030,13.9944241843,1042,11.5743629025,2072
SC,2020,4,20,7.985958447,1106,14.5151073345,1118,11.2681475011,2224
SC,2020,4,21,8.550298819,1138,16.1430762332,1115,12.3079316716,2253
SC,2020,4,22,11.46939574,1175,20.853260298,1141,16.0924481842,2316
SC,2020,4,23,11.02025399,1220,18.9927243844,1259,15.0692012375,2479
SC,2020,4,24,9.024424177,1094,20.8304851974,1216,15.2392164717,2310
SC,2020,4,25,6.699215318,994,23.0824170616,1055,15.134685225,2049
SC,2020,4,26,9.618069838,974,19.255531281,1007,14.517072197,1981
SC,2020,4,27,7.572624983,1040,18.2416921606,1046,12.9225023885,2086
SC,2020,4,28,6.428350693,1055,21.2852974504,1059,13.8708798397,2114
SC,2020,4,29,9.304258933,1066,23.1653157399,1061,16.2184955442,2127
SC,2020,4,30,11.07429479,1099,19.7417327189,1085,15.3802335047,2184
SC,2020,5,1,8.513656296,960,24.3857593857,1172,17.2388461746,2132
SC,2020,5,2,11.58952923,977,21.2815145436,997,16.48462009,1974
SC,2020,5,3,12.41384689,993,17.4548377863,1048,15.0022635775,2041
SC,2020,5,4,11.75538669,1125,18.690462075,1147,15.2565008918,2272
SC,2020,5,5,10.5428623,1097,21.3704065041,1107,15.9811977963,2204
SC,2020,5,6,11.46648399,1095,16.3376443203,1074,13.8784831577,2169
SC,2020,5,7,13.83633724,1103,18.1588777372,1096,15.9907275924,2199
SC,2020,5,8,14.15460947,1037,17.5889416058,1096,15.9192733335,2133
SC,2020,5,9,11.88416908,981,25.3042337917,1018,18.7183991333,1999
SC,2020,5,10,16.41098374,986,19.697751938,1032,18.0918285271,2018
SC,2020,5,11,13.16160907,1013,25.7454616896,1018,19.4690251048,2031
SC,2020,5,12,16.29963832,1023,22.2106498545,1031,19.2666553074,2054
SC,2020,5,13,14.56234645,1010,20.372906221,1077,17.560895982,2087
SC,2020,5,14,15.22303495,1028,21.2656794055,942,18.1124618927,1970
SC,2020,5,15,15.42862688,1056,22.2700974314,1129,18.9636475905,2185
SC,2020,5,16,16.639339,1059,26.7709596413,1115,21.8356393749,2174
SC,2020,5,17,17.06996077,1019,30.4812578616,1113,24.0712617376,2132
SC,2020,5,18,15.16550686,1075,31.7544095941,1084,23.4945344486,2159
SC,2020,5,19,13.03379998,1100,24.4858769513,1089,18.7310644029,2189
SC,2020,5,20,15.01256894,1125,24.5614685315,1144,19.8269987032,2269
SC,2020,5,21,20.80799471,1142,22.3176410256,1170,21.5719593247,2312
SC,2020,5,22,22.23258187,1038,32.1818909411,1137,27.4336689568,2175
SC,2020,5,23,17.77774067,987,28.0028250244,1023,22.9818507668,2010
SC,2020,5,24,18.14860177,1037,26.1924134871,1127,22.3377772807,2164
SC,2020,5,25,19.76870473,1050,28.6474393531,1113,24.3373740021,2163
SC,2020,5,26,15.86559672,1081,24.0942346471,1091,19.9988582202,2172
SC,2020,5,27,12.47579967,1088,23.2590239411,1086,17.8624517208,2174
SC,2020,5,28,15.02799097,1110,28.2004340278,1152,21.7365030843,2262
SC,2020,5,29,20.17322618,1088,21.250338843,1210,20.740374275,2298
SC,2020,5,30,15.59828216,1106,21.3806820049,1217,18.6276324016,2323
SC,2020,5,31,17.34419768,1072,25.7063333333,1170,21.7080240468,2242
SC,2020,6,1,17.73055197,1105,31.2480033557,1192,24.7452677087,2297
SC,2020,6,2,12.42510107,1088,21.2252985702,1189,17.0203732825,2277
SC,2020,6,3,11.72009119,1096,26.1836161097,1167,19.1787450041,2263
SC,2020,6,4,21.6080133,1057,25.8811913357,1108,23.7949330522,2165
SC,2020,6,5,17.29021388,982,24.4343521898,1096,21.0582483302,2078
SC,2020,6,6,19.3556561,1006,32.498884652,1049,26.0647786066,2055
SC,2020,6,7,23.39965958,940,26.3624056604,1060,24.9699150026,2000
SC,2020,6,8,13.35745715,995,25.4645020747,964,19.3151862503,1959
SC,2020,6,9,11.68087653,1061,27.2855322862,1146,19.783701857,2207
SC,2020,6,10,11.03390485,1114,20.9335625,1120,15.9970277542,2234
SC,2020,6,11,17.5823721,1075,22.9081222707,1145,20.3292117151,2220
SC,2020,6,12,24.27481401,995,26.5102409639,1079,25.4377964995,2074
SC,2020,6,13,21.70632671,1010,22.5678571429,1022,22.1396358155,2032
SC,2020,6,14,24.28049905,1002,26.3080896686,1026,25.3062919369,2028
SC,2020,6,15,13.40741585,1010,28.1982868142,1039,20.907520746,2049
SC,2020,6,16,15.452819,1011,24.6601585821,1072,20.1913058133,2083
SC,2020,6,17,13.4321734,1072,24.8286351228,1099,19.2012712505,2171
SC,2020,6,18,25.8888704,1142,28.8427179487,1170,27.3836807945,2312
SC,2020,6,19,27.93968701,1087,26.1503767123,1168,27.0128956895,2255
SC,2020,6,20,29.30989537,1051,30.7306186519,1083,30.0309091068,2134
SC,2020,6,21,26.00021546,1021,38.4124517375,1036,32.2515896863,2057
SC,2020,6,22,19.30403996,1052,25.1811194732,1063,22.2578629021,2115
SC,2020,6,23,16.16560642,1047,27.56839819,1105,22.0206644618,2152
SC,2020,6,24,21.70564441,1063,30.0679733587,1051,25.8630747435,2114
SC,2020,6,25,21.7279461,1076,25.7875160403,1091,23.7717812661,2167
SC,2020,6,26,28.46871068,1016,25.2375625579,1079,26.8045537236,2095
SC,2020,6,27,21.92548398,1023,28.0267824497,1094,25.0784459667,2117
SC,2020,6,28,20.77521694,1037,29.8573154982,1084,25.4168929593,2121
SC,2020,6,29,17.23664188,1072,31.3139945652,1104,24.3788281688,2176
SC,2020,6,30,15.42678152,1044,24.2207001795,1114,19.9663669633,2158
SC,2020,7,1,19.29091822,1089,30.5277280702,1140,25.0378734597,2229
SC,2020,7,2,23.74804331,1109,25.6130748422,1109,24.6805590761,2218
SC,2020,7,3,26.33136884,1125,27.5217781852,1091,26.9174413109,2216
SC,2020,7,4,19.94191824,1100,26.2642553191,1128,23.1428142118,2228
SC,2020,7,5,27.01720567,1070,28.6948615091,1047,27.8469202017,2117
SC,2020,7,6,24.34674904,1132,32.5990622182,1109,28.430557748,2241
SC,2020,7,7,19.98176465,1071,27.6662807657,1097,23.8701014484,2168
SC,2020,7,8,14.39793901,1082,23.8409315068,1095,19.1476297698,2177
SC,2020,7,9,18.37111578,1174,30.3049333333,1200,24.4033740209,2374
SC,2020,7,10,28.55928888,1097,29.518011745,1192,29.0585451732,2289
SC,2020,7,11,21.42514267,1052,28.5577798165,1090,25.0547292665,2142
SC,2020,7,12,22.8919851,1078,24.263635514,1070,23.5752560232,2148
SC,2020,7,13,19.36092409,1093,22.9607149085,1147,21.204209835,2240
SC,2020,7,14,16.03656315,1094,23.9669324578,1066,19.9503472621,2160
SC,2020,7,15,16.65765444,1117,25.2003456998,1186,21.0569735169,2303
SC,2020,7,16,21.62835012,1091,27.3101669596,1138,24.5291610502,2229
SC,2020,7,17,22.71524091,996,29.9523119266,1090,26.4968360241,2086
SC,2020,7,18,20.38645122,1006,34.107659372,1051,27.3971414328,2057
SC,2020,7,19,26.47627859,1005,32.3792842942,1006,29.4292491213,2011
SC,2020,7,20,20.14204363,1101,22.6387184284,1069,21.3719723671,2170
SC,2020,7,21,14.66199095,1090,23.6402750665,1127,19.2260532862,2217
SC,2020,7,22,15.28675621,1116,22.8822898032,1118,19.0879229769,2234
SC,2020,7,23,19.87540278,1105,26.2934401349,1186,23.197878687,2291
SC,2020,7,24,27.33556092,1043,33.1502434783,1150,30.38475606,2193
SC,2020,7,25,21.13929131,1016,34.5025045537,1098,28.0800709418,2114
SC,2020,7,26,25.05702702,999,24.3231463878,1052,24.6806045797,2051
SC,2020,7,27,16.7537871,1014,29.0184543762,1074,23.0623372219,2088
SC,2020,7,28,15.63047074,1062,25.7292890995,1055,20.6631837156,2117
SC,2020,7,29,18.55879228,1151,25.0388055798,1147,21.7931592316,2298
SC,2020,7,30,16.72446613,1077,26.2774893978,1179,21.7169370665,2256
SC,2020,7,31,22.01047849,1024,29.9789208633,1112,26.1588436207,2136
SD,2020,1,1,53.89867609,136,32.7107831325,166,42.252350822,302
SD,2020,1,2,38.92396783,126,27.5325641026,117,33.4392178872,243
SD,2020,1,3,21.56102202,137,51.97125,144,37.1449110916,281
SD,2020,1,4,24.22732955,176,40.5954117647,170,32.2694508694,346
SD,2020,1,5,23.73421047,152,18.9655191257,183,21.129223855,335
SD,2020,1,6,31.66227562,145,63.3203759398,133,46.8080574277,278
SD,2020,1,7,37.14525331,158,34.5038,150,35.8588312434,308
SD,2020,1,8,23.2105881,136,32.973,120,27.7867186781,256
SD,2020,1,9,26.02577638,161,23.7032432432,148,24.9133656867,309
SD,2020,1,10,46.22049694,161,30.9752439024,164,38.5275077149,325
SD,2020,1,11,36.23368043,144,39.8889304813,187,38.2987310632,331
SD,2020,1,12,48.49185419,151,27.9868309859,142,38.5542661525,293
SD,2020,1,13,35.97421953,173,36.9847953216,171,36.4765697055,344
SD,2020,1,14,27.42683311,120,20.1078787879,165,23.1895437656,285
SD,2020,1,15,49.40721745,115,18.46,97,35.2474056922,212
SD,2020,1,16,15.53194626,149,28.9206622517,151,22.2709333091,300
SD,2020,1,17,11.74832301,161,27.6881065089,169,19.9114242564,330
SD,2020,1,18,15.95426018,169,19.0498064516,155,17.4351542297,324
SD,2020,1,19,51.02751511,157,23.9538172043,186,36.3461512311,343
SD,2020,1,20,20.98111123,153,42.5146043165,139,31.2316438979,292
SD,2020,1,21,22.92684523,168,27.4923376623,154,25.1103416107,322
SD,2020,1,22,24.00683087,142,41.2986705202,173,33.5036189954,315
SD,2020,1,23,38.20244881,147,44.7555555556,144,41.445223282,291
SD,2020,1,24,29.7188093,168,45.8935483871,155,37.4806809981,323
SD,2020,1,25,31.66795556,181,43.2371153846,156,37.0234123334,337
SD,2020,1,26,16.54677444,155,30.7984831461,178,24.1648049195,333
SD,2020,1,27,21.90817494,137,18.2265116279,129,20.122706642,266
SD,2020,1,28,16.86578584,140,39.13859375,128,27.5035448418,268
SD,2020,1,29,18.68259853,127,34.9761643836,146,27.3963736751,273
SD,2020,1,30,40.19086664,150,41.8180136986,146,40.9934459324,296
SD,2020,1,31,24.26916056,143,41.066641791,134,32.3950179064,277
SD,2020,2,1,42.83221015,181,42.4516770186,161,42.6530702841,342
SD,2020,2,2,9.496526175,95,40.9365104167,192,30.5295469917,287
SD,2020,2,3,33.34267637,71,32.6620289855,69,33.0072144448,140
SD,2020,2,4,18.08240597,133,29.2692063492,126,23.5246331815,259
SD,2020,2,5,25.56407166,140,38.7343870968,155,32.4840679064,295
SD,2020,2,6,45.31986867,76,42.0260909091,110,43.3719355856,186
SD,2020,2,7,10.17577765,90,12.4097014925,67,11.129108207,157
SD,2020,2,8,25.72113352,150,32.0124223602,161,28.9780386752,311
SD,2020,2,9,40.19902242,133,38.4950746269,134,39.34385761,267
SD,2020,2,10,31.72935285,139,25.475210084,119,28.8446901014,258
SD,2020,2,11,29.55022238,135,35.3426241135,141,32.5093841351,276
SD,2020,2,12,34.42793328,150,52.54,112,42.1704961527,262
SD,2020,2,13,48.82900615,161,43.1025827815,151,46.057564071,312
SD,2020,2,14,40.85437482,160,52.2480392157,153,46.4238018249,313
SD,2020,2,15,24.43777794,144,31.0333774834,151,27.8138305877,295
SD,2020,2,16,38.51208318,144,29.5138345865,133,34.191624469,277
SD,2020,2,17,39.35196913,132,32.3198449612,129,35.8763215523,261
SD,2020,2,18,27.81693335,150,16.20176,125,22.5373091,275
SD,2020,2,19,40.21870985,155,31.8197902098,143,36.1883557945,298
SD,2020,2,20,23.60128869,163,59.1218987342,158,41.0849534469,321
SD,2020,2,21,48.94267494,157,25.6932903226,155,37.3924998897,312
SD,2020,2,22,34.6780555,144,47.4929107981,213,42.323893535,357
SD,2020,2,23,37.56700766,127,38.7912413793,145,38.219632253,272
SD,2020,2,24,19.48970997,138,27.5574825175,143,23.5953735796,281
SD,2020,2,25,34.21672953,159,38.6800729927,137,36.2825337678,296
SD,2020,2,26,37.84650021,180,49.3719708029,137,42.8275395514,317
SD,2020,2,27,38.66180239,172,30.8645333333,150,35.0295341959,322
SD,2020,2,28,38.83690044,171,44.300304878,164,41.5115223141,335
SD,2020,2,29,48.6376921,169,60.9181621622,185,55.0554518782,354
SD,2020,3,1,31.43388513,139,32.9746099291,141,32.2097501181,280
SD,2020,3,2,55.9921431,154,37.1449206349,126,47.5108929907,280
SD,2020,3,3,35.58368726,160,40.1901290323,155,37.8503490844,315
SD,2020,3,4,26.98645597,158,46.3179874214,159,36.6827130702,317
SD,2020,3,5,31.4191282,172,38.0350769231,130,34.267053147,302
SD,2020,3,6,25.5663936,183,65.3750595238,168,44.6201140422,351
SD,2020,3,7,45.01834369,163,52.2142105263,171,48.7024551541,334
SD,2020,3,8,39.68321443,140,44.290952381,147,42.0432753317,287
SD,2020,3,9,32.07245378,163,34.7700763359,131,33.2744556671,294
SD,2020,3,10,30.94836176,177,50.2814124294,177,40.6148870947,354
SD,2020,3,11,38.79429979,200,38.0937647059,170,38.4724323189,370
SD,2020,3,12,36.48930484,187,28.2205181347,193,32.2896315923,380
SD,2020,3,13,31.60086121,151,43.5006779661,177,38.0224086668,328
SD,2020,3,14,27.22927626,152,48.2817687075,147,37.5794982994,299
SD,2020,3,15,20.669871,155,36.7147945205,146,28.4524584884,301
SD,2020,3,16,30.84851855,189,24.8261935484,155,28.1349709475,344
SD,2020,3,17,27.98795358,171,33.5597647059,170,30.7656893319,341
SD,2020,3,18,17.7223436,192,20.7347058824,170,19.1369888707,362
SD,2020,3,19,16.31374304,187,17.382752809,178,16.835068352,365
SD,2020,3,20,8.707759644,183,21.9102312139,173,15.1235674574,356
SD,2020,3,21,11.31147049,170,37.7933165829,199,25.5930080848,369
SD,2020,3,22,6.522532637,154,30.0266666667,156,18.350419439,310
SD,2020,3,23,9.274999751,188,27.8007594937,158,17.7347397491,346
SD,2020,3,24,11.19546728,214,19.202238806,201,15.0734457781,415
SD,2020,3,25,7.968018935,212,28.0253846154,195,17.5778133028,407
SD,2020,3,26,11.49597032,201,28.2149541284,218,20.1946301535,419
SD,2020,3,27,12.07839783,181,36.1245555556,180,24.0681717652,361
SD,2020,3,28,21.6115344,189,16.3926219512,164,19.1868838572,353
SD,2020,3,29,24.14864713,170,20.0251829268,164,22.123952132,334
SD,2020,3,30,8.398387179,186,23.3762820513,156,15.2304094014,342
SD,2020,3,31,20.11641418,198,21.0575903614,166,20.5456318891,364
SD,2020,4,1,12.83306874,189,41.4308988764,178,26.7034059724,367
SD,2020,4,2,11.58271738,184,19.8305699482,193,15.8050928327,377
SD,2020,4,3,15.44910696,168,20.9438607595,158,18.1122084947,326
SD,2020,4,4,9.028385128,161,13.3320338983,177,11.2820710225,338
SD,2020,4,5,13.61209005,177,24.935477707,157,18.934760296,334
SD,2020,4,6,5.770289064,173,17.2640229885,174,11.5337176025,347
SD,2020,4,7,3.099691313,162,38.7303205128,156,20.5788679016,318
SD,2020,4,8,6.42508877,169,17.3948823529,170,11.926165198,339
SD,2020,4,9,20.39791662,168,20.2430967742,155,20.3236222667,323
SD,2020,4,10,16.49526335,152,14.5249700599,167,15.463793195,319
SD,2020,4,11,6.480628976,159,26.2307051282,156,16.2616190704,315
SD,2020,4,12,12.75019705,152,16.0704666667,150,14.3993375881,302
SD,2020,4,13,25.01975612,164,26.2215151515,165,25.6224620173,329
SD,2020,4,14,24.5973514,185,26.7132352941,170,25.6105915746,355
SD,2020,4,15,10.67291213,182,14.5848314607,178,12.6071389102,360
SD,2020,4,16,8.841818251,165,27.889068323,161,18.2485889921,326
SD,2020,4,17,6.971764752,136,28.414875,160,18.5626351563,296
SD,2020,4,18,7.345360057,125,26.3772058824,136,17.262337192,261
SD,2020,4,19,17.58595266,126,12.6322137405,131,15.0608950784,257
SD,2020,4,20,21.53688894,135,29.00078125,128,25.1695057297,263
SD,2020,4,21,18.06706677,150,19.9956349206,126,18.9475000562,276
SD,2020,4,22,18.93850925,161,23.1248461538,130,20.8086941211,291
SD,2020,4,23,22.42512196,164,22.2285795455,176,22.3233823572,340
SD,2020,4,24,10.75972411,145,25.0026174497,149,17.9780612107,294
SD,2020,4,25,17.14000005,144,30.525703125,128,23.4391544382,272
SD,2020,4,26,11.74144047,118,31.3666666667,117,21.5122977679,235
SD,2020,4,27,22.77936056,125,23.0860952381,105,22.9193916087,230
SD,2020,4,28,6.244403033,134,39.7074590164,122,22.1916406501,256
SD,2020,4,29,9.156783178,143,20.4293846154,130,14.5246886244,273
SD,2020,4,30,10.61490463,157,24.5892361111,144,17.3002990927,301
SD,2020,5,1,9.182182939,142,32.6675147929,169,21.9443086088,311
SD,2020,5,2,13.71342083,114,26.7774193548,124,20.5198738429,238
SD,2020,5,3,10.45583953,137,16.4811666667,120,13.2692218506,257
SD,2020,5,4,9.799562099,137,17.5893233083,133,13.6367407688,270
SD,2020,5,5,5.246381642,152,19.5302173913,138,12.0435172744,290
SD,2020,5,6,8.312056756,141,21.572,130,14.6729151387,271
SD,2020,5,7,8.108246726,154,34.5749305556,144,20.8975167644,298
SD,2020,5,8,12.26309545,126,21.3652142857,140,17.0536843109,266
SD,2020,5,9,11.91120316,133,21.8898639456,147,17.1500000724,280
SD,2020,5,10,44.19826782,127,27.5058646617,133,35.659461589,260
SD,2020,5,11,21.58795614,137,51.1254700855,117,35.1938188629,254
SD,2020,5,12,12.2742658,143,28.1257251908,131,19.852883246,274
SD,2020,5,13,6.334806201,129,38.6520325203,123,22.1086904759,252
SD,2020,5,14,12.44659097,132,39.4368032787,122,25.4103937324,254
SD,2020,5,15,26.7088891,144,28.4781410256,156,27.6289001013,300
SD,2020,5,16,14.45888884,126,20.4618978102,137,17.5859315355,263
SD,2020,5,17,6.868468512,111,34.100625,128,21.4530544135,239
SD,2020,5,18,21.49941592,137,29.9366911765,136,25.7026006632,273
SD,2020,5,19,21.24471009,138,38.6810687023,131,29.7360222767,269
SD,2020,5,20,28.3700678,147,32.2641984733,131,30.2050718223,278
SD,2020,5,21,26.75855054,138,43.0348951049,143,35.0415301584,281
SD,2020,5,22,33.73466157,133,46.4602255639,133,40.097443567,266
SD,2020,5,23,23.14008126,123,35.27816,125,29.2580644959,248
SD,2020,5,24,17.05098234,112,22.71344,125,20.0375106417,237
SD,2020,5,25,19.58000041,107,41.4462962963,108,30.564000204,215
SD,2020,5,26,23.44687978,125,30.3067716535,127,26.9040475099,252
SD,2020,5,27,34.82495938,123,41.8521186441,118,38.265643169,241
SD,2020,5,28,28.37192561,135,23.1030769231,117,25.9256744339,252
SD,2020,5,29,15.88872342,141,45.0861313869,137,30.2773741087,278
SD,2020,5,30,19.84369201,130,43.371221374,131,31.6525285874,261
SD,2020,5,31,30.17464819,142,37.6141007194,139,33.8546620747,281
SD,2020,6,1,23.89242854,140,58.6956338028,142,41.4174467929,282
SD,2020,6,2,12.04111882,143,35.2525503356,149,23.8853081892,292
SD,2020,6,3,30.86721415,140,32.4462676056,142,31.6623403582,282
SD,2020,6,4,36.07435338,147,42.5629452055,146,39.3075766104,293
SD,2020,6,5,34.61054778,146,57.2058666667,150,46.0608782969,296
SD,2020,6,6,44.86380601,134,55.4366891892,148,50.4126950544,282
SD,2020,6,7,62.03155009,129,71.4926666667,120,66.5911243438,249
SD,2020,6,8,36.4984422,122,68.9896923077,130,53.2598013825,252
SD,2020,6,9,23.43830654,124,43.2608396947,131,33.6216471018,255
SD,2020,6,10,14.13367512,117,42.4897321429,112,28.0021396901,229
SD,2020,6,11,23.10926216,122,38.1242307692,130,30.8550792997,252
SD,2020,6,12,25.21955777,113,38.705631068,103,31.6504167963,216
SD,2020,6,13,24.58209691,124,30.9206,100,27.4117857895,224
SD,2020,6,14,25.29882343,119,49.962248062,129,38.1277822104,248
SD,2020,6,15,19.94382378,136,27.4874774775,111,23.3338867777,247
SD,2020,6,16,22.90777033,148,35.9666917293,133,29.0886833055,281
SD,2020,6,17,13.82951047,143,25.3640714286,140,19.5356537004,283
SD,2020,6,18,23.03027773,144,44.6834265734,143,33.8191288959,287
SD,2020,6,19,17.91846789,124,49.4667142857,140,34.6485985544,264
SD,2020,6,20,27.6481577,114,35.8958992806,139,32.179525604,253
SD,2020,6,21,29.02029602,135,53.9536363636,132,41.3468912461,267
SD,2020,6,22,13.2763502,137,33.3922794118,136,23.2974724447,273
SD,2020,6,23,23.72465232,144,35.6200694444,144,29.6723608822,288
SD,2020,6,24,29.25313434,134,24.7826153846,130,27.0517424302,264
SD,2020,6,25,17.99233075,133,43.0377099237,131,30.4201514763,264
SD,2020,6,26,17.3750002,118,43.0182258065,124,30.5145042298,242
SD,2020,6,27,19.50992204,129,27.4151515152,132,23.5079691309,261
SD,2020,6,28,23.20759136,137,62.9274603175,126,42.2368821913,263
SD,2020,6,29,26.69839431,137,34.9985833333,120,30.5739689512,257
SD,2020,6,30,19.42575738,132,44.2825517241,145,32.4374367298,277
SD,2020,7,1,50.38520884,144,39.9872307692,130,45.4518615801,274
SD,2020,7,2,31.89110468,163,60.7738636364,132,44.8149154673,295
SD,2020,7,3,28.96352941,187,74.4712716763,173,50.8325277769,360
SD,2020,7,4,44.27779879,159,121.0201,200,87.0311699376,359
SD,2020,7,5,38.82946103,130,61.0897794118,136,50.2106764432,266
SD,2020,7,6,27.74556281,151,66.3263870968,155,47.2881372036,306
SD,2020,7,7,28.18285707,161,41.2618543046,151,34.5127563727,312
SD,2020,7,8,24.05314824,162,33.7172297297,148,28.6669677899,310
SD,2020,7,9,18.25733323,165,59.8063636364,165,39.0318484332,330
SD,2020,7,10,35.30452688,148,57.8490361446,166,47.2229617141,314
SD,2020,7,11,32.26568165,132,70.9222695035,141,52.2311720799,273
SD,2020,7,12,41.34789499,133,57.4581428571,140,49.6095605629,273
SD,2020,7,13,20.01390066,141,37.7779617834,157,29.3728187687,298
SD,2020,7,14,21.90436606,142,77.6905517241,145,50.0890243224,287
SD,2020,7,15,26.7744187,129,46.4389932886,149,37.3140647924,278
SD,2020,7,16,14.92041966,143,38.4882706767,133,26.2773913456,276
SD,2020,7,17,22.04028999,138,49.4550344828,145,36.0867138467,283
SD,2020,7,18,40.49876913,130,52.2356034483,116,46.0332113289,246
SD,2020,7,19,29.97361511,130,47.145,122,38.2867458901,252
SD,2020,7,20,29.68412589,143,43.7460150376,133,36.4603260952,276
SD,2020,7,21,20.07166685,144,51.1203649635,137,35.2092883502,281
SD,2020,7,22,22.70675489,151,40.5543274854,171,32.1848136285,322
SD,2020,7,23,32.19071869,167,49.5286585366,164,40.7811178889,331
SD,2020,7,24,37.29591167,159,53.5523125,160,45.4495923371,319
SD,2020,7,25,35.88645403,141,53.0846456693,127,44.0363433516,268
SD,2020,7,26,28.63206631,121,36.1385483871,124,32.4312654021,245
SD,2020,7,27,27.77626684,150,38.2344262295,122,32.4670589191,272
SD,2020,7,28,17.70469407,147,25.1365734266,143,21.3693794079,290
SD,2020,7,29,37.13827579,145,49.4577272727,132,43.0089169298,277
SD,2020,7,30,51.62350648,154,55.9284920635,126,53.5607499926,280
SD,2020,7,31,30.25045781,131,56.7613333333,135,43.7052254628,266
TN,2020,1,1,31.4555792,2918,37.5503825137,2928,34.5081936547,5846
TN,2020,1,2,26.01251373,2908,26.4992065711,2861,26.2538776091,5769
TN,2020,1,3,24.17795364,3020,31.9740077959,2822,27.9438668252,5842
TN,2020,1,4,22.36138446,3012,27.1623700306,3270,24.8604648191,6282
TN,2020,1,5,26.13064863,2775,31.3413484741,2818,28.7560289555,5593
TN,2020,1,6,13.36424199,2810,24.4149155033,2722,18.8016847418,5532
TN,2020,1,7,13.83549878,2817,21.8536695589,2766,17.8079616807,5583
TN,2020,1,8,16.14068818,2906,27.7875037481,2668,21.7154466902,5574
TN,2020,1,9,21.46874873,2933,23.1147128437,2873,22.2832259775,5806
TN,2020,1,10,21.92294174,2937,30.5301710011,2807,26.1291556216,5744
TN,2020,1,11,18.56578469,3103,19.3972329794,3202,18.988036462,6305
TN,2020,1,12,21.83563089,3099,24.4485233969,2885,23.0953559706,5984
TN,2020,1,13,18.65233508,3246,24.7173000316,3163,21.6455452753,6409
TN,2020,1,14,17.21253415,2490,27.3428556979,2966,22.7195967803,5456
TN,2020,1,15,20.90803391,2304,16.6104911181,1914,18.9579398124,4218
TN,2020,1,16,24.33453614,2835,22.1411263318,2628,23.2793867759,5463
TN,2020,1,17,22.32706787,2800,29.9712543676,2862,26.1910137824,5662
TN,2020,1,18,19.7642105,2812,28.0289791356,2684,23.8003529705,5496
TN,2020,1,19,24.40940135,2756,29.1207700136,2948,26.844379404,5704
TN,2020,1,20,21.24670773,2767,26.5193591654,2684,23.8428912656,5451
TN,2020,1,21,15.81967461,2797,21.0505122494,2694,18.3860334883,5491
TN,2020,1,22,17.35466351,2779,22.3813195489,2660,19.8130023707,5439
TN,2020,1,23,20.46823759,2769,26.8363414634,2665,23.5913507337,5434
TN,2020,1,24,19.07151331,2630,28.4364573643,2580,23.7090479857,5210
TN,2020,1,25,18.44522871,2733,21.0592966238,2488,19.6909289532,5221
TN,2020,1,26,20.20473145,2737,23.9073453094,3006,22.1427529129,5743
TN,2020,1,27,14.31763306,2649,21.5278307939,2494,17.8140812708,5143
TN,2020,1,28,14.86967173,2742,22.3740409401,2638,18.5493233984,5380
TN,2020,1,29,14.72334164,2807,22.4582366071,2688,18.5070354838,5495
TN,2020,1,30,19.24742316,2961,23.9775073529,2720,21.5121351834,5681
TN,2020,1,31,21.38071871,2755,24.0149667017,2853,22.7208594947,5608
TN,2020,2,1,19.7914695,2831,26.6291771218,2710,23.1356650703,5541
TN,2020,2,2,16.0262282,1840,23.3886339697,3038,20.6115067421,4878
TN,2020,2,3,20.19103214,1647,15.4161090641,1357,18.0340512432,3004
TN,2020,2,4,12.50258162,2634,15.626836302,2358,13.9783413436,4992
TN,2020,2,5,12.04295774,2840,19.0708314679,3127,15.7259074881,5967
TN,2020,2,6,22.96962531,1281,19.7329737374,2475,20.8368477162,3756
TN,2020,2,7,10.61848142,1396,7.22981269511,961,9.23684771418,2357
TN,2020,2,8,18.24999237,2616,21.4684123484,2721,19.8908619149,5337
TN,2020,2,9,22.42494299,2456,25.8377633648,2544,24.1613859967,5000
TN,2020,2,10,15.98812577,2513,20.9575020678,2418,18.4249442425,4931
TN,2020,2,11,15.1910696,2459,23.3476762505,2539,19.33465189,4998
TN,2020,2,12,18.6083891,2570,18.7373766234,2310,18.6694467186,4880
TN,2020,2,13,19.89600206,2904,28.7947792494,2718,24.1981856959,5622
TN,2020,2,14,22.09650809,2626,33.3183208289,2799,27.8863429022,5425
TN,2020,2,15,18.84184933,2455,27.0101748678,2459,22.9293366107,4914
TN,2020,2,16,23.43027471,2512,22.6472367347,2450,23.0436477371,4962
TN,2020,2,17,18.92294256,2661,28.403191812,2638,23.6424929519,5299
TN,2020,2,18,16.18461015,2809,24.7884372564,2566,20.2920371928,5375
TN,2020,2,19,15.49137752,2853,24.8840683453,2780,20.1268613642,5633
TN,2020,2,20,19.6321875,2784,26.4998490837,2783,23.065401473,5567
TN,2020,2,21,21.98311168,2587,27.8681252401,2603,24.9346897719,5190
TN,2020,2,22,19.08201161,2411,23.1051309846,3321,21.4129221898,5732
TN,2020,2,23,23.13108335,2400,27.7633574776,2347,25.4213608679,4747
TN,2020,2,24,19.27115091,2711,26.9343802601,2614,23.0329690361,5325
TN,2020,2,25,20.09759318,2871,26.1221888412,2796,23.0700247079,5667
TN,2020,2,26,18.69557993,2828,23.7930965594,2703,21.1867365833,5531
TN,2020,2,27,25.0714141,2871,24.4740503099,2743,24.7795421947,5614
TN,2020,2,28,24.66520355,2850,29.9395031285,2717,27.2393497606,5567
TN,2020,2,29,27.36204933,2596,28.6184218235,2731,28.006155446,5327
TN,2020,3,1,26.13103827,2456,32.2861213947,2323,29.1229315738,4779
TN,2020,3,2,20.3681428,2983,22.9425187821,2529,21.5493105901,5512
TN,2020,3,3,17.46953826,3118,28.2290963855,3486,23.1490990755,6604
TN,2020,3,4,17.16437806,2846,24.5116101083,2770,20.7882799072,5616
TN,2020,3,5,23.39150128,2791,37.904512987,2772,30.6232230941,5563
TN,2020,3,6,25.43892777,2602,32.3668261031,2697,28.9649783087,5299
TN,2020,3,7,28.43819946,2477,30.4652762646,2570,29.4704141198,5047
TN,2020,3,8,28.59886602,2425,28.4293159753,2266,28.5169644209,4691
TN,2020,3,9,20.23363844,2655,26.4059920635,2520,23.2393062914,5175
TN,2020,3,10,17.30804782,2971,23.1626928729,2722,20.1073353369,5693
TN,2020,3,11,19.73092158,3342,24.966569729,3026,22.2188410679,6368
TN,2020,3,12,22.40168566,3340,26.2243881857,3318,24.3067212533,6658
TN,2020,3,13,21.19732135,2841,25.7093282341,3007,23.5173631935,5848
TN,2020,3,14,18.51674408,2755,23.8906503745,2537,21.0930101928,5292
TN,2020,3,15,17.57716228,2865,22.9198669131,2705,20.171779162,5570
TN,2020,3,16,11.4492995,3169,19.4204842533,2953,15.2942698653,6122
TN,2020,3,17,13.36407986,3206,20.1905191434,3082,16.709990463,6288
TN,2020,3,18,10.98387459,3141,18.321272239,2979,14.5554607986,6120
TN,2020,3,19,8.937018272,3280,23.4499135638,3008,15.8795737806,6288
TN,2020,3,20,10.68881518,3106,20.2753581483,3197,15.5512898539,6303
TN,2020,3,21,11.02795825,2924,16.8918855567,2901,13.9483450512,5825
TN,2020,3,22,6.711439376,2779,17.5103078556,2826,12.1561498708,5605
TN,2020,3,23,5.701556145,3046,11.2659517988,2863,8.39759011976,5909
TN,2020,3,24,6.857163244,3222,14.1170911441,3094,10.4135623768,6316
TN,2020,3,25,7.371873999,3159,13.3972463768,3036,10.3247441425,6195
TN,2020,3,26,7.74731185,3162,14.3431008264,3025,10.9721803895,6187
TN,2020,3,27,6.421530845,2920,17.1280492676,3004,11.8506971755,5924
TN,2020,3,28,6.152669294,2791,17.8505396353,2687,11.8905622489,5478
TN,2020,3,29,5.849388311,2812,12.4800659341,2730,9.11567302969,5542
TN,2020,3,30,6.622628913,2948,14.0450601983,2824,10.2541164303,5772
TN,2020,3,31,5.631874152,2956,10.2845711103,2693,7.84991502802,5649
TN,2020,4,1,6.765803469,2931,15.8426503568,2943,11.3134984623,5874
TN,2020,4,2,6.882318668,2868,14.2604289834,2774,10.5099113683,5642
TN,2020,4,3,6.369710622,2799,14.94441877,2813,10.6677601623,5612
TN,2020,4,4,5.431960429,2678,12.9108799403,2682,9.17421082628,5360
TN,2020,4,5,5.045968662,2679,12.7166899767,2574,8.80466591386,5253
TN,2020,4,6,5.09225659,2876,10.5527380511,2699,7.73581523818,5575
TN,2020,4,7,5.610120449,2989,12.465687545,2778,8.9124900333,5767
TN,2020,4,8,6.330881317,2655,14.305405694,2810,10.4312314541,5465
TN,2020,4,9,6.459927881,2496,15.948087408,2311,11.0214291639,4807
TN,2020,4,10,8.013858143,2509,14.8687311412,2585,11.492430326,5094
TN,2020,4,11,5.777948185,2432,13.9248610517,2339,9.77200167385,4771
TN,2020,4,12,5.937667957,2560,11.2134036511,2465,8.52566566566,5025
TN,2020,4,13,5.560224598,2627,17.1405163776,2595,11.3148889351,5222
TN,2020,4,14,5.943986578,2679,13.6005238283,2539,9.66954197824,5218
TN,2020,4,15,6.289126618,2725,13.6849925262,2676,9.95351046733,5401
TN,2020,4,16,8.007069459,2706,14.6624159258,2587,11.2599281988,5293
TN,2020,4,17,5.884585365,2460,15.3405335968,2530,10.6788837671,4990
TN,2020,4,18,4.653232715,2419,13.0131364031,2302,8.72959329328,4721
TN,2020,4,19,5.206878307,2457,10.5142975894,2406,7.83275755713,4863
TN,2020,4,20,6.390317586,2519,13.5974897119,2430,9.92909880766,4949
TN,2020,4,21,7.278974839,2585,11.4599459684,2406,9.29448606668,4991
TN,2020,4,22,6.722716589,2724,13.3334338086,2455,9.85639312385,5179
TN,2020,4,23,6.342588523,2797,14.8833177233,2776,10.5968616721,5573
TN,2020,4,24,7.646682945,2457,15.4830899961,2589,11.6673840658,5046
TN,2020,4,25,7.661794288,2324,15.0173636364,2310,11.3284678302,4634
TN,2020,4,26,8.244636426,2269,13.992663406,2249,11.1059274127,4518
TN,2020,4,27,7.366864215,2312,13.1761660617,2204,10.2020505016,4516
TN,2020,4,28,7.36980352,2443,12.5258836689,2235,9.83321504903,4678
TN,2020,4,29,7.662192874,2499,12.7987563238,2372,10.1635126241,4871
TN,2020,4,30,8.57437699,2488,17.3737817884,2438,12.9294214273,4926
TN,2020,5,1,8.439499572,2258,21.1224838969,2484,15.0832222762,4742
TN,2020,5,2,7.637684519,2168,16.7088485134,2119,12.1214252478,4287
TN,2020,5,3,7.844202974,2296,14.9776963581,2279,11.3976961811,4575
TN,2020,5,4,8.620381064,2467,16.5209298394,2366,12.4881026453,4833
TN,2020,5,5,9.542562512,2439,15.9302557545,2346,12.6743343713,4785
TN,2020,5,6,7.70864634,2460,14.1502807316,2351,10.8564913732,4811
TN,2020,5,7,9.686383838,2392,13.2380042463,2355,11.4483526734,4747
TN,2020,5,8,9.476831306,2187,17.2299956005,2273,13.428163692,4460
TN,2020,5,9,11.12880605,2161,17.7650560748,2140,14.4307300335,4301
TN,2020,5,10,10.21004732,2111,22.8221375117,2138,16.556163778,4249
TN,2020,5,11,7.695843306,2259,17.7237595785,2088,12.5125649938,4347
TN,2020,5,12,8.979341298,2338,16.3941406946,2246,12.6123341961,4584
TN,2020,5,13,9.130371969,2151,14.8541100602,2326,12.1041076849,4477
TN,2020,5,14,8.621982628,2189,13.9859570005,1907,11.1193212824,4096
TN,2020,5,15,10.77455991,2261,18.4967143458,2377,14.7322056827,4638
TN,2020,5,16,11.41068053,2160,19.2571821461,2218,15.3859067942,4378
TN,2020,5,17,10.93848645,2134,17.7577511962,2090,14.3126018192,4224
TN,2020,5,18,10.97365872,2315,21.0444652651,2188,15.8670463995,4503
TN,2020,5,19,8.935590384,2363,20.2298321234,2204,14.3861068705,4567
TN,2020,5,20,10.23502539,2360,16.6728528139,2310,13.4194753577,4670
TN,2020,5,21,13.9716442,2372,24.1987494336,2207,18.9009347112,4579
TN,2020,5,22,13.49915559,2179,24.0984518099,2293,18.9339020641,4472
TN,2020,5,23,9.868235356,2040,21.1977827603,2007,15.4868174268,4047
TN,2020,5,24,14.99523872,2094,20.8344628099,2057,17.8888267597,4151
TN,2020,5,25,12.35991739,2179,21.2703210117,2056,16.6857237291,4235
TN,2020,5,26,12.8030524,2290,16.1683642954,2207,14.4546519893,4497
TN,2020,5,27,11.69384618,2314,19.5955184691,2247,15.5866454858,4561
TN,2020,5,28,12.2304162,2451,18.280021322,2345,15.1883653266,4796
TN,2020,5,29,15.10937272,2423,19.0914399364,2514,17.13710555,4937
TN,2020,5,30,12.73080189,2357,20.2903787879,2376,16.5257637977,4733
TN,2020,5,31,14.07824177,2275,22.0362468724,2398,18.1619773222,4673
TN,2020,6,1,12.67543838,2361,23.413707256,2398,18.0863164562,4759
TN,2020,6,2,7.451443527,2390,15.8011620017,2358,11.5981655496,4748
TN,2020,6,3,9.324541709,2455,15.4651133086,2427,12.3772183317,4882
TN,2020,6,4,10.53506297,2382,14.7518712446,2330,12.6201994895,4712
TN,2020,6,5,12.39269486,2104,18.8730588756,2259,15.7479876199,4363
TN,2020,6,6,12.46444844,1967,18.7699303829,2011,15.6520613578,3978
TN,2020,6,7,13.57982249,1971,19.6786430678,2034,16.6772010307,4005
TN,2020,6,8,12.31622452,2111,19.4902175013,1977,15.785643337,4088
TN,2020,6,9,10.86103096,2260,16.2255306218,2139,13.4695021527,4399
TN,2020,6,10,12.25570214,2236,18.3395688073,2180,15.2590602321,4416
TN,2020,6,11,13.90389621,2274,19.0785137615,2180,16.4366008041,4454
TN,2020,6,12,15.43414333,2066,21.9502487095,2131,18.7426543054,4197
TN,2020,6,13,12.68390916,1980,27.6143954918,1952,20.0959918964,3932
TN,2020,6,14,16.50160559,2074,24.4691065292,2037,20.4495013363,4111
TN,2020,6,15,10.10928637,2228,18.3176520509,2121,14.1124925345,4349
TN,2020,6,16,10.68487153,2297,20.0367643021,2185,15.24397142,4482
TN,2020,6,17,11.52799066,2354,19.8153153153,2220,15.5502601691,4574
TN,2020,6,18,14.32258617,2351,22.6714892704,2330,18.4783102084,4681
TN,2020,6,19,16.95134039,2186,24.8520790378,2328,21.0259791964,4514
TN,2020,6,20,17.49057428,2159,25.4465472155,2065,21.3800354807,4224
TN,2020,6,21,18.83282578,2141,26.7319418386,2132,22.7740650585,4273
TN,2020,6,22,12.53673225,2237,21.3461053622,2126,16.8293582497,4363
TN,2020,6,23,11.72924289,2219,21.0241368078,2149,16.3022115323,4368
TN,2020,6,24,11.49245056,2330,21.6919402985,2144,16.3801810024,4474
TN,2020,6,25,17.18599225,2318,20.5075343072,2259,18.8253550438,4577
TN,2020,6,26,16.25152618,2136,23.1972955688,2189,19.7669687677,4325
TN,2020,6,27,16.83743016,2148,22.2535341942,2091,19.5090681726,4239
TN,2020,6,28,19.7875753,2190,21.6212112542,2097,20.6845042937,4287
TN,2020,6,29,13.31941731,2351,23.2193122421,2181,18.083687135,4532
TN,2020,6,30,11.09051386,2277,22.3495291577,2315,16.7666071558,4592
TN,2020,7,1,17.22135054,2325,27.5269122658,2348,22.3994928323,4673
TN,2020,7,2,18.21560228,2258,23.1038623411,2281,20.672117195,4539
TN,2020,7,3,16.39817422,2180,24.4654507628,2163,20.4160234399,4343
TN,2020,7,4,15.17437444,2046,27.0183341003,2173,21.2746172326,4219
TN,2020,7,5,18.79136863,2075,24.9152322614,1959,21.7652528278,4034
TN,2020,7,6,13.90968366,2307,23.0589991063,2238,18.4148911339,4545
TN,2020,7,7,11.74340721,2301,20.8988793493,2213,16.231900751,4514
TN,2020,7,8,12.45181551,2374,18.3514311512,2215,15.2994181784,4589
TN,2020,7,9,16.21992976,2421,18.4931871472,2303,17.328166797,4724
TN,2020,7,10,16.09738514,2176,26.6421822126,2305,21.521566629,4481
TN,2020,7,11,16.39995702,2096,20.6753330092,2057,18.5175704103,4153
TN,2020,7,12,17.82204949,2181,23.0001290631,2092,20.3571635707,4273
TN,2020,7,13,13.86506072,2306,24.9546011717,2219,19.3032243139,4525
TN,2020,7,14,9.748584797,2346,21.1872698556,2216,15.304947377,4562
TN,2020,7,15,10.58874844,2349,21.8945656735,2383,16.282273898,4732
TN,2020,7,16,15.6824379,2334,19.9405469097,2249,17.7720052495,4583
TN,2020,7,17,14.53149357,2156,21.9789925209,2273,18.3536125845,4429
TN,2020,7,18,13.03375502,1992,18.8240317919,2076,15.9886750245,4068
TN,2020,7,19,17.94517177,2096,21.3362081041,1999,19.6005274798,4095
TN,2020,7,20,14.50340361,2277,22.6525213483,2225,18.5308996046,4502
TN,2020,7,21,10.24915876,2318,17.7275722022,2216,13.9042457004,4534
TN,2020,7,22,14.10422951,2362,22.8812194056,2288,18.4228860436,4650
TN,2020,7,23,14.11308255,2339,22.4268512257,2366,18.2938214845,4705
TN,2020,7,24,15.57116872,2199,22.7296433176,2327,19.2516305823,4526
TN,2020,7,25,12.90683001,2041,24.5881747948,2071,18.7901143119,4112
TN,2020,7,26,16.53213274,1974,27.5837727037,1927,21.9913765775,3901
TN,2020,7,27,17.26178017,2129,24.7944594595,2072,20.9770173725,4201
TN,2020,7,28,11.90878921,2263,18.5011388889,2160,15.1282048343,4423
TN,2020,7,29,12.13148345,2366,22.4722758307,2197,17.1103834851,4563
TN,2020,7,30,17.58936513,2457,19.8913119789,2279,18.6970798405,4736
TN,2020,7,31,17.85543533,2125,20.3747246503,2288,19.1616066341,4413
TX,2020,1,1,18.85666325,17646,38.2381833412,19101,28.9311296081,36747
TX,2020,1,2,15.63374012,17553,34.9720930929,16693,25.0601001672,34246
TX,2020,1,3,16.10809342,17639,36.5760329268,18283,26.5255350436,35922
TX,2020,1,4,15.58056793,17308,32.6935235258,17789,24.2543111871,35097
TX,2020,1,5,15.93197857,16972,35.586358898,17459,25.8981667767,34431
TX,2020,1,6,12.74324109,17380,31.4511092553,17363,22.0925982254,34743
TX,2020,1,7,11.63372835,17249,31.4791659325,17025,21.4915965545,34274
TX,2020,1,8,12.59400738,17685,30.9881531106,16942,21.5937364056,34627
TX,2020,1,9,14.23245963,18572,32.2850391455,17882,23.0879001001,36454
TX,2020,1,10,16.58018926,17487,33.5256119003,18655,25.3267129542,36142
TX,2020,1,11,15.20415363,17250,32.9660200413,16965,24.0111115042,34215
TX,2020,1,12,17.28478715,17971,34.1496418853,18374,25.8107148128,36345
TX,2020,1,13,14.49935122,18805,33.1864807166,18643,23.8024957192,37448
TX,2020,1,14,10.11936516,14807,30.9751097749,18128,21.598731742,32935
TX,2020,1,15,14.58375822,13799,24.2432535257,12196,19.1156760792,25995
TX,2020,1,16,17.08922947,17482,31.2512286253,16433,23.9512118412,33915
TX,2020,1,17,17.36453659,16887,45.0697545071,18249,31.754123389,35136
TX,2020,1,18,14.19293577,16728,33.1175320532,16301,23.5329050096,33029
TX,2020,1,19,17.45142443,16877,34.7797938559,17415,26.2515397208,34292
TX,2020,1,20,14.63949838,17105,33.8921035813,16586,24.1175106049,33691
TX,2020,1,21,10.24804979,17998,32.1484877493,17550,21.0602666851,35548
TX,2020,1,22,10.85906609,18075,29.4779061617,17690,20.0682728807,35765
TX,2020,1,23,13.38785604,17547,30.5375132306,17384,21.9226715506,34931
TX,2020,1,24,14.36862078,16335,36.1980914918,17160,25.5521919821,33495
TX,2020,1,25,13.19475395,17335,30.6667925113,16131,21.6164791049,33466
TX,2020,1,26,16.01094091,17462,30.9568317582,19787,23.9503310202,37249
TX,2020,1,27,12.41658297,16842,32.7602514372,15829,22.2730283854,32671
TX,2020,1,28,10.72879048,17693,30.5392103265,17121,20.4712561028,34814
TX,2020,1,29,10.55887732,17850,30.2309470912,17464,20.2873993363,35314
TX,2020,1,30,13.39933165,18254,31.2386773513,17533,22.1393000234,35787
TX,2020,1,31,16.8010356,16782,35.7354484046,18209,26.6543328124,34991
TX,2020,2,1,15.75974474,17277,38.8004463091,16446,26.9962117805,33723
TX,2020,2,2,11.77386389,12125,32.1878851497,19434,24.3447973531,31559
TX,2020,2,3,14.38244319,10519,22.2537911912,9377,18.0922155165,19896
TX,2020,2,4,9.65477023,16603,24.7721355695,14310,16.6527807113,30913
TX,2020,2,5,10.03484511,17560,29.2691921218,19446,20.1421550595,37006
TX,2020,2,6,19.20773668,8386,28.8657482972,15709,25.5043834737,24095
TX,2020,2,7,10.29951262,9028,18.005561597,6437,13.5070029055,15465
TX,2020,2,8,13.93406538,16215,32.7315741361,16409,23.3887098497,32624
TX,2020,2,9,17.1138023,15943,32.4268961171,16663,24.9394197408,32606
TX,2020,2,10,10.81987764,16592,30.9017807626,16156,20.7271460792,32748
TX,2020,2,11,9.636820594,15720,29.672139751,16787,19.9832968203,32507
TX,2020,2,12,12.47883912,16074,27.6866528783,14505,19.6925916483,30579
TX,2020,2,13,15.22930783,18319,30.9400884805,17631,22.9343641207,35950
TX,2020,2,14,16.3665421,16831,36.2599069084,18369,26.747826707,35200
TX,2020,2,15,13.77540313,15602,30.9888809048,16004,22.4916120241,31606
TX,2020,2,16,16.55127059,15898,31.422245469,15725,23.9460806957,31623
TX,2020,2,17,12.28609291,16941,31.1299945858,16623,21.6187760693,33564
TX,2020,2,18,10.9473812,17806,32.4535313856,17285,21.5408041848,35091
TX,2020,2,19,11.81162279,17846,31.1913945934,18163,21.5868121945,36009
TX,2020,2,20,14.6229263,17107,32.7661257987,17059,23.6817813093,34166
TX,2020,2,21,16.91858301,16048,36.3638101415,16960,26.9098291367,33008
TX,2020,2,22,14.84357376,15583,34.6388747588,20209,26.0204635087,35792
TX,2020,2,23,17.55469224,15939,34.3227824894,16036,25.9641713718,31975
TX,2020,2,24,12.21820176,17317,33.4592682056,16808,22.6803217547,34125
TX,2020,2,25,11.14742752,17656,31.5041804598,17400,21.2514753621,35056
TX,2020,2,26,13.01893587,17789,30.7906431427,17259,21.770416577,35048
TX,2020,2,27,14.54345401,17927,33.9513326914,17656,24.1734881836,35583
TX,2020,2,28,16.37464702,16843,38.5318800313,17888,27.7866013002,34731
TX,2020,2,29,16.76053441,15513,34.6327379868,16461,25.9615834835,31974
TX,2020,3,1,17.92124187,15863,36.8891728499,15499,27.2951326377,31362
TX,2020,3,2,13.09643167,17476,36.0052357714,17008,24.3953801724,34484
TX,2020,3,3,12.15036344,17692,32.5102794468,17642,22.3159161142,35334
TX,2020,3,4,13.98662736,17467,30.888642413,17207,22.374265735,34674
TX,2020,3,5,14.99319565,17555,32.3116564345,17103,23.539494767,34658
TX,2020,3,6,18.78373558,16019,36.6507555429,17590,28.1348284762,33609
TX,2020,3,7,18.33100662,14802,37.0632326342,15591,27.9402632182,30393
TX,2020,3,8,19.27156645,14670,37.222804423,14741,28.2688531441,29411
TX,2020,3,9,13.97197491,15940,34.9432432432,15355,24.2616002577,31295
TX,2020,3,10,13.07581492,17560,31.0717175526,16442,21.7779098287,34002
TX,2020,3,11,13.28635354,19534,33.4935736067,19020,23.2552627497,38554
TX,2020,3,12,14.70847625,19465,36.0736211127,19969,25.5275810267,39434
TX,2020,3,13,14.70297803,17458,34.6762692328,18913,25.0891333878,36371
TX,2020,3,14,13.08659652,16348,32.032209097,16423,22.5810823566,32771
TX,2020,3,15,14.34281562,17925,31.5643407975,16702,22.6494524501,34627
TX,2020,3,16,9.782189103,20433,29.3668570724,20290,19.5401370219,40723
TX,2020,3,17,8.373100526,20203,25.8222259469,19987,17.0507733249,40190
TX,2020,3,18,7.576141699,20408,24.5405756765,19438,15.8518699441,39846
TX,2020,3,19,7.218144171,20891,22.9476637991,19994,14.9103544057,40885
TX,2020,3,20,6.917056509,20000,22.7583113674,20638,14.9620345534,40638
TX,2020,3,21,7.187969173,18682,19.7644980027,18775,13.4918463863,37457
TX,2020,3,22,6.4042618,18403,19.7281759524,17823,12.9595569454,36226
TX,2020,3,23,4.849216677,19711,19.5308508364,18711,11.9989761054,38422
TX,2020,3,24,4.720113384,20286,19.6656834204,19717,12.0866060072,40003
TX,2020,3,25,4.61824674,20710,18.5463011341,19752,11.4173898963,40462
TX,2020,3,26,4.662478488,20686,18.2007525712,20224,11.3551711074,40910
TX,2020,3,27,4.939704319,19075,19.2558437203,19977,12.2631068802,39052
TX,2020,3,28,4.382746254,17999,18.1785740751,17813,11.2448338497,35812
TX,2020,3,29,4.534897171,18184,17.6897628014,17791,11.0404764464,35975
TX,2020,3,30,4.44788701,19186,16.4182609391,18763,10.366359856,37949
TX,2020,3,31,4.289511975,19589,18.5645136124,18586,11.2394839575,38175
TX,2020,4,1,3.966928981,19671,20.0222975863,19638,11.9878740234,39309
TX,2020,4,2,4.215398745,19373,17.5830982952,18536,10.7516745334,37909
TX,2020,4,3,4.520831029,18459,19.7596980816,19078,12.2659120325,37537
TX,2020,4,4,4.160511356,17639,17.0396609008,17517,10.577739214,35156
TX,2020,4,5,3.874548767,17464,15.9844745783,17072,9.86078496835,34536
TX,2020,4,6,4.036967627,18263,16.3730680729,17731,10.1138525802,35994
TX,2020,4,7,3.734096314,18646,17.2943985256,17906,10.3769823777,36552
TX,2020,4,8,3.810698712,17289,16.9461968435,18248,10.5556847801,35537
TX,2020,4,9,4.281786957,16570,16.2248841355,15708,10.0938623793,32278
TX,2020,4,10,4.513488615,16336,19.8216989081,16852,12.2865981685,33188
TX,2020,4,11,3.699147004,15979,16.8195982455,15731,10.2080659091,31710
TX,2020,4,12,4.362532643,16007,16.5831402726,15919,10.4559941745,31926
TX,2020,4,13,4.315566365,16862,17.689651491,16298,10.8888727396,33160
TX,2020,4,14,4.069777885,17333,17.7625967541,16821,10.8135533197,34154
TX,2020,4,15,4.467701731,17400,17.7606052926,16967,11.0304128996,34367
TX,2020,4,16,4.489365696,17405,19.3465312167,16882,11.804635866,34287
TX,2020,4,17,4.253422399,16503,20.4916482826,17497,12.6098999956,34000
TX,2020,4,18,4.284072948,15544,18.2968462676,15553,11.2924873751,31097
TX,2020,4,19,5.145596725,15384,17.1507550609,15363,11.1440761706,30747
TX,2020,4,20,4.826448683,15949,18.6116102232,15768,11.6796954329,31717
TX,2020,4,21,4.8154667,16306,18.749231558,15603,11.6288589429,31909
TX,2020,4,22,5.168880945,17211,19.155054368,16186,11.9473401786,33397
TX,2020,4,23,4.763695721,17339,19.2458218549,17424,12.0224641172,34763
TX,2020,4,24,4.980092964,15598,21.3517802669,16784,13.4657454775,32382
TX,2020,4,25,4.866031973,14385,20.9131912419,14615,12.9532468942,29000
TX,2020,4,26,5.393862097,14386,19.8917635426,14159,12.5851665836,28545
TX,2020,4,27,4.423408879,15090,20.7362238185,14896,12.5270469547,29986
TX,2020,4,28,4.39018154,15313,18.9591820385,14854,11.5638459218,30167
TX,2020,4,29,4.805773907,15648,20.4440692669,15101,12.4858252332,30749
TX,2020,4,30,6.226154034,16022,20.1761968622,15361,13.0542650458,31383
TX,2020,5,1,7.365555546,15012,26.5000023875,16754,17.4574312112,31766
TX,2020,5,2,6.08091313,13711,22.5679901576,14021,14.4166013964,27732
TX,2020,5,3,5.989635001,14192,22.7699747292,13850,14.2774784229,28042
TX,2020,5,4,5.158381286,15574,21.2578881701,15148,13.0965145547,30722
TX,2020,5,5,4.325553327,15452,21.4976893495,15342,12.8809508349,30794
TX,2020,5,6,5.811376374,15330,21.1654018629,15030,13.4125293087,30360
TX,2020,5,7,6.609564269,15354,23.521402314,15125,15.0019508444,30479
TX,2020,5,8,7.847527478,14196,26.3256975762,15389,17.4591739083,29585
TX,2020,5,9,7.531045003,13713,24.2543863519,13599,15.8578141522,27312
TX,2020,5,10,8.316022201,13603,26.7075240696,13918,17.6170259075,27521
TX,2020,5,11,6.796560007,14221,24.4332686155,13752,15.467064307,27973
TX,2020,5,12,6.35345929,14847,21.4277816052,14515,13.805396774,29362
TX,2020,5,13,4.958373987,13573,21.8235235613,14579,13.6922833236,28152
TX,2020,5,14,6.209766014,13762,20.3816027088,12847,13.052021868,26609
TX,2020,5,15,7.95813412,14181,26.432863021,15068,17.4756292508,29249
TX,2020,5,16,7.831154196,13308,22.4767077799,13702,15.2607497238,27010
TX,2020,5,17,8.24595037,13295,24.872308694,13055,16.4834117711,26350
TX,2020,5,18,6.76230704,14356,23.4117480775,14044,14.9955728826,28400
TX,2020,5,19,6.286578633,14614,24.3960321697,14237,15.2229860366,28851
TX,2020,5,20,6.748350076,14728,24.4498099122,14467,15.5199554691,29195
TX,2020,5,21,7.6441757,14649,25.9308112911,14631,16.7818726035,29280
TX,2020,5,22,8.586294026,13543,27.1763142306,14518,18.204266063,28061
TX,2020,5,23,8.620172349,12881,26.9891227269,13143,17.8971134348,26024
TX,2020,5,24,9.699275623,13184,26.4371775116,13109,18.0443543838,26293
TX,2020,5,25,8.938124776,13657,27.7210779026,13350,18.2228444502,27007
TX,2020,5,26,6.347881306,14287,26.6153501959,14035,16.3914490579,28322
TX,2020,5,27,7.204372102,14485,24.4418114333,14414,15.8019170178,28899
TX,2020,5,28,8.387343488,15080,25.3806029532,14628,16.7546990642,29708
TX,2020,5,29,9.705605694,14512,27.7066515113,15616,19.0359406476,30128
TX,2020,5,30,8.151899199,13848,26.2561974761,14422,17.3878450693,28270
TX,2020,5,31,11.88634833,13583,25.9170218426,14284,19.078157296,27867
TX,2020,6,1,8.580746853,14434,29.3606701818,14414,18.9635052716,28848
TX,2020,6,2,6.583792253,14527,23.1219378776,15228,15.047676695,29755
TX,2020,6,3,7.096937029,13882,23.4090163821,14406,15.4040571916,28288
TX,2020,6,4,8.510718846,13633,25.0128654124,13820,16.8179954842,27453
TX,2020,6,5,9.524836541,12449,27.6866512516,13623,19.0146494361,26072
TX,2020,6,6,9.284987614,11699,28.1437664447,12314,18.9558743221,24013
TX,2020,6,7,9.75723926,11783,28.8194045462,12142,19.4313379394,23925
TX,2020,6,8,8.259859329,12867,26.225963607,12365,17.0641903133,25232
TX,2020,6,9,7.108310745,13503,25.4909057426,13304,16.2313772518,26807
TX,2020,6,10,8.408967866,13564,24.9293955056,13350,16.603502643,26914
TX,2020,6,11,8.880911004,13304,27.0015581192,13696,18.0727770369,27000
TX,2020,6,12,10.53420241,12431,32.4838629616,13135,21.81124189,25566
TX,2020,6,13,9.736692971,12162,29.7458591135,12251,19.7777487369,24413
TX,2020,6,14,11.16398437,12406,31.2733234824,12520,21.2646393362,24926
TX,2020,6,15,8.479022984,13265,27.3868148599,13136,17.8867254984,26401
TX,2020,6,16,8.51146524,13677,24.6651498937,13643,16.5782558597,27320
TX,2020,6,17,8.02775311,13926,27.0838684761,13853,17.5307721592,27779
TX,2020,6,18,9.390550573,13895,27.2181557522,14125,18.3775214208,28020
TX,2020,6,19,11.70889009,12767,31.4148362081,13798,21.9442616141,26565
TX,2020,6,20,11.04237974,12741,29.5906639004,12532,20.2398274945,25273
TX,2020,6,21,11.58561043,12860,31.3162700016,12874,21.4563072251,25734
TX,2020,6,22,8.639685374,13476,27.2189269995,13178,17.8254453403,26654
TX,2020,6,23,8.131206543,13634,24.4746129829,13772,16.3440575059,27406
TX,2020,6,24,8.598416719,13554,25.373928678,13404,16.9395014545,26958
TX,2020,6,25,8.429340501,13768,26.7579905993,13616,17.5427972545,27384
TX,2020,6,26,9.962851041,13381,27.8335565688,14036,19.1116719473,27417
TX,2020,6,27,9.406173419,13124,27.7810294781,13298,18.6541045322,26422
TX,2020,6,28,9.845294093,13362,27.7949369062,13472,18.8569057789,26834
TX,2020,6,29,8.49549619,13906,25.9934208612,13748,17.1944716865,27654
TX,2020,6,30,7.176177472,13151,25.9449274634,13924,16.8284794066,27075
TX,2020,7,1,9.935414052,13742,33.3242549397,14019,21.7465217356,27761
TX,2020,7,2,10.18226687,13565,28.4306988976,13879,19.4108774265,27444
TX,2020,7,3,10.34020978,13157,29.6953076298,13539,20.1562372668,26696
TX,2020,7,4,10.20175051,12345,28.9033790935,13039,19.8082165949,25384
TX,2020,7,5,12.1882785,12187,29.6116771212,12116,20.8745270164,24303
TX,2020,7,6,9.740626521,13248,28.9994855355,13101,19.3163338324,26349
TX,2020,7,7,8.309685725,13555,26.8639037673,13405,17.5351787835,26960
TX,2020,7,8,9.364865021,13819,26.5754516837,13660,17.9203660877,27479
TX,2020,7,9,9.53878388,13798,27.7519325646,13702,18.6135679991,27500
TX,2020,7,10,9.562348841,12934,30.0797179618,13757,20.1373534116,26691
TX,2020,7,11,8.998632222,12553,27.5459397666,12684,18.3204235956,25237
TX,2020,7,12,11.23778763,12855,27.6629868217,12900,19.4647365554,25755
TX,2020,7,13,9.221523162,13820,26.8852923869,13595,17.9809228561,27415
TX,2020,7,14,7.790488456,13860,25.6623778525,13672,16.6654147901,27532
TX,2020,7,15,7.996537704,13699,25.4507776141,13580,16.6855870819,27279
TX,2020,7,16,9.667308638,13469,28.8889463901,13449,19.270986702,26918
TX,2020,7,17,10.91962281,12380,29.391252467,13174,20.4424078574,25554
TX,2020,7,18,10.23412772,11946,29.3714315491,11994,19.8219649016,23940
TX,2020,7,19,11.7815221,12417,29.7934979797,12127,20.6810996543,24544
TX,2020,7,20,8.921032964,13379,27.6043906155,13128,18.1742535943,26507
TX,2020,7,21,8.432102472,13484,27.7443441252,13158,17.9700679278,26642
TX,2020,7,22,8.802126983,13893,28.152686032,13667,18.3980664069,27560
TX,2020,7,23,11.23810668,14044,28.4954754122,14072,19.8753841305,28116
TX,2020,7,24,10.80396338,12999,31.4236804503,13857,21.4432030078,26856
TX,2020,7,25,9.9823047,12314,27.6048547521,12668,18.9184372779,24982
TX,2020,7,26,11.96609688,12285,27.7552755523,12357,19.8837529491,24642
TX,2020,7,27,10.74069098,13054,28.1584429998,12614,19.3002797278,25668
TX,2020,7,28,8.027237506,13477,26.0994289568,13344,17.0185250314,26821
TX,2020,7,29,9.281330804,13488,26.3603752678,13537,17.8363363509,27025
TX,2020,7,30,10.71496191,13390,28.4377062389,13528,19.621763503,26918
TX,2020,7,31,12.052225,12036,30.4059451058,13189,21.6485466838,25225
UT,2020,1,1,30.4458499,853,30.6085730212,897,30.5292571227,1750
UT,2020,1,2,31.15449161,846,32.5016354557,801,31.8096599284,1647
UT,2020,1,3,30.75703266,856,31.7515571776,822,31.2442192831,1678
UT,2020,1,4,23.12426205,847,29.3307701564,831,26.1979260765,1678
UT,2020,1,5,32.28736238,872,20.9796365768,853,26.6957739104,1725
UT,2020,1,6,22.9026346,873,25.3913245823,838,24.1215254271,1711
UT,2020,1,7,28.16381629,925,27.7531674757,824,27.9703488097,1749
UT,2020,1,8,24.84968311,947,20.9215046296,864,22.9756101078,1811
UT,2020,1,9,24.20142267,949,23.7854719101,890,24.0001196921,1839
UT,2020,1,10,29.39984638,846,24.2589491917,866,26.7993691808,1712
UT,2020,1,11,21.79689772,851,28.3329044118,816,24.9962867185,1667
UT,2020,1,12,27.0123837,881,28.5848300971,824,27.7723226039,1705
UT,2020,1,13,19.10725086,913,19.5188331389,857,19.3065310933,1770
UT,2020,1,14,14.93197988,697,34.6429735936,871,25.881135189,1568
UT,2020,1,15,22.83966896,665,24.0740909091,572,23.4104768459,1237
UT,2020,1,16,29.74032674,887,22.3071293001,843,26.1182542303,1730
UT,2020,1,17,35.26045145,864,34.5211264368,870,34.8895098344,1734
UT,2020,1,18,26.02925398,858,26.7137733499,803,26.3601805628,1661
UT,2020,1,19,25.91382944,833,24.2917954816,841,25.0989366329,1674
UT,2020,1,20,30.82839553,885,41.6309067688,783,35.8993585396,1668
UT,2020,1,21,21.1255879,893,34.4873156682,868,27.7116070384,1761
UT,2020,1,22,29.17588171,947,25.0533411489,853,27.2222555441,1800
UT,2020,1,23,34.10523675,1014,31.2012458655,907,32.7341176806,1921
UT,2020,1,24,27.13859646,1026,34.0432894737,988,30.5258043535,2014
UT,2020,1,25,23.62427744,1031,28.9647390841,939,26.1698071272,1970
UT,2020,1,26,25.50205094,1019,36.9909553024,1141,31.5709582907,2160
UT,2020,1,27,30.02253899,961,43.7410939227,905,36.6759646138,1866
UT,2020,1,28,30.83885786,972,42.7188241881,893,36.5272277962,1865
UT,2020,1,29,33.53173285,981,45.4933183857,892,39.2283341836,1873
UT,2020,1,30,29.43210678,1049,31.1631522897,939,30.2497384367,1988
UT,2020,1,31,33.68642258,942,27.6549327818,967,30.6311839028,1909
UT,2020,2,1,31.91984786,986,47.696185446,852,39.2329270892,1838
UT,2020,2,2,30.46218458,682,37.9199048525,1051,34.9850143587,1733
UT,2020,2,3,23.71939651,547,15.2952495379,541,19.5305513704,1088
UT,2020,2,4,20.18860097,822,30.2155944056,715,24.8530774218,1537
UT,2020,2,5,19.22602322,948,32.9830278064,971,26.1869671769,1919
UT,2020,2,6,37.0027453,459,23.2408547009,819,28.1835055498,1278
UT,2020,2,7,13.29950827,488,10.7269252874,348,12.2286244447,836
UT,2020,2,8,27.13713817,877,25.2503767123,876,26.1942955933,1753
UT,2020,2,9,31.80442883,788,32.4160613208,848,32.1214608301,1636
UT,2020,2,10,25.62880712,788,39.5071077763,733,32.3170348524,1521
UT,2020,2,11,18.29042241,805,17.3561007958,754,17.8385439641,1559
UT,2020,2,12,24.14277525,854,27.2708920863,695,25.5462879687,1549
UT,2020,2,13,24.44352826,975,23.4094532199,823,23.9702002522,1798
UT,2020,2,14,34.71781625,838,32.0538733906,932,33.3151073545,1770
UT,2020,2,15,19.07195571,767,44.3170284939,737,31.4427127856,1504
UT,2020,2,16,30.73125285,790,27.3130171278,759,29.0563394135,1549
UT,2020,2,17,25.76036089,831,38.7179949559,793,32.0875799874,1624
UT,2020,2,18,18.6233864,880,31.5417861482,823,24.8663946166,1703
UT,2020,2,19,22.83846685,874,16.5561575758,825,19.7879046656,1699
UT,2020,2,20,31.06972378,905,26.9296506024,830,29.0891700409,1735
UT,2020,2,21,26.98354055,853,33.1330612245,833,30.0218268619,1686
UT,2020,2,22,29.27341417,823,28.5584857143,1050,28.8726267282,1873
UT,2020,2,23,32.60089721,847,36.3398108747,846,34.469249815,1693
UT,2020,2,24,31.05270817,949,25.4698210024,838,28.4346558776,1787
UT,2020,2,25,24.84053336,975,27.4509307605,881,26.0796282468,1856
UT,2020,2,26,25.8188751,969,31.9164897075,923,28.7935570676,1892
UT,2020,2,27,28.13322334,940,28.9580232558,860,28.5272944109,1800
UT,2020,2,28,33.0745128,924,36.6120134983,889,34.8091173895,1813
UT,2020,2,29,32.31717131,806,28.8062747381,859,30.5058438894,1665
UT,2020,3,1,32.74853091,810,50.1549674055,767,41.2144388314,1577
UT,2020,3,2,23.71655689,912,41.2870574163,836,32.1198397504,1748
UT,2020,3,3,20.73965965,940,31.2268303571,896,25.857581738,1836
UT,2020,3,4,26.26442753,917,24.6486394558,882,25.4722512757,1799
UT,2020,3,5,25.80831174,930,21.3758029197,822,23.7286757524,1752
UT,2020,3,6,30.14920936,898,31.3014722537,883,30.7204884926,1781
UT,2020,3,7,31.54332917,823,28.0381227437,831,29.7822490368,1654
UT,2020,3,8,36.39348108,813,45.3321780822,730,40.6224174453,1543
UT,2020,3,9,26.4031389,857,37.1220204604,782,31.5173337628,1639
UT,2020,3,10,22.3445064,952,37.5135649203,878,29.6223388485,1830
UT,2020,3,11,22.45264117,1151,25.439257087,1023,23.8580266728,2174
UT,2020,3,12,24.45224125,1169,35.5249032801,1189,30.0355301193,2358
UT,2020,3,13,25.98054728,1005,22.9207017544,1026,24.4348055226,2031
UT,2020,3,14,23.74794539,915,27.7857127883,954,25.8089566784,1869
UT,2020,3,15,19.77293944,956,34.0815393387,877,26.6188980385,1833
UT,2020,3,16,18.62509718,1028,16.0660148778,941,17.4020923824,1969
UT,2020,3,17,13.48253879,1288,16.965628192,979,14.9867048794,2267
UT,2020,3,18,9.85806642,1355,16.5235587393,1745,13.6100935481,3100
UT,2020,3,19,11.77602551,1097,16.5746442688,1012,14.0786344165,2109
UT,2020,3,20,14.00151746,1061,17.1483771107,1066,15.578645992,2127
UT,2020,3,21,13.26324741,970,19.2552025586,938,16.208977981,1908
UT,2020,3,22,11.22986488,962,12.9224787234,940,12.0663827626,1902
UT,2020,3,23,11.52609651,994,12.2078716904,982,11.8649139327,1976
UT,2020,3,24,12.65850336,1049,23.574047619,1008,18.0074915044,2057
UT,2020,3,25,8.024621279,1043,13.5934579439,963,10.697996009,2006
UT,2020,3,26,9.451203756,1055,17.03271,1000,13.1405011983,2055
UT,2020,3,27,10.27480201,985,13.3159157689,1021,11.8226470488,2006
UT,2020,3,28,8.070699538,872,21.2770964126,892,14.7487641707,1764
UT,2020,3,29,9.602611116,900,20.6594545455,825,14.8906666692,1725
UT,2020,3,30,8.37536891,976,14.8842367257,904,11.5051649235,1880
UT,2020,3,31,10.33620654,1036,12.6918658281,954,11.4655025002,1990
UT,2020,4,1,11.86401386,1004,21.6485136502,989,16.7194430082,1993
UT,2020,4,2,8.019212107,990,14.7787486157,903,11.2436502831,1893
UT,2020,4,3,9.86987158,1013,15.4129162358,967,12.5770050053,1980
UT,2020,4,4,8.208714431,949,13.9322063666,911,11.011994621,1860
UT,2020,4,5,6.90589327,862,17.672440678,885,12.360040068,1747
UT,2020,4,6,8.928068977,870,12.5458241758,819,10.6823268265,1689
UT,2020,4,7,8.314767702,904,12.5560702152,883,10.4104980429,1787
UT,2020,4,8,7.066378134,878,11.9246091015,857,9.46609221997,1735
UT,2020,4,9,10.90219643,865,14.5526142132,788,12.6423834918,1653
UT,2020,4,10,10.46967485,861,13.5274178404,852,11.9905137454,1713
UT,2020,4,11,7.112096766,806,16.1096325459,762,11.4846237203,1568
UT,2020,4,12,7.790831114,770,14.6528979592,735,11.1420730616,1505
UT,2020,4,13,6.75961799,890,14.1161042184,806,10.2556839688,1696
UT,2020,4,14,5.668054399,956,13.3139448568,943,9.46482886016,1899
UT,2020,4,15,6.349601643,954,13.7338435374,882,9.89693353345,1836
UT,2020,4,16,8.53237585,926,11.8732664437,897,10.1762479633,1823
UT,2020,4,17,8.159839695,811,14.6034430082,851,11.4591817044,1662
UT,2020,4,18,9.032880308,802,11.5664868421,760,10.2656210032,1562
UT,2020,4,19,9.767708615,755,16.7004527297,751,13.2248738409,1506
UT,2020,4,20,9.884670826,805,20.0973727648,727,14.7310378688,1532
UT,2020,4,21,12.98720877,867,9.19365435356,758,11.2176615407,1625
UT,2020,4,22,15.83376323,853,19.1375505051,792,17.4244012372,1645
UT,2020,4,23,11.73482923,849,22.0798574822,842,16.8859314112,1691
UT,2020,4,24,8.896958959,707,20.4957369062,821,15.1290248586,1528
UT,2020,4,25,7.53017236,696,13.9964317841,667,10.6945120782,1363
UT,2020,4,26,12.99575925,731,21.5644733242,731,17.2801162871,1462
UT,2020,4,27,7.668706145,742,9.36456066946,717,8.50210415325,1459
UT,2020,4,28,7.409391566,756,11.996,700,9.61449177465,1456
UT,2020,4,29,9.078291448,796,20.998872077,727,14.7685489118,1523
UT,2020,4,30,12.77844933,819,24.6139393939,825,18.7177919716,1644
UT,2020,5,1,13.64564379,730,28.0588806888,813,21.239915727,1543
UT,2020,5,2,9.317672945,636,15.6786615385,650,12.5327915964,1286
UT,2020,5,3,10.95609545,671,10.50829653,634,10.7385440973,1305
UT,2020,5,4,10.82232332,736,16.4041441441,666,13.4738872778,1402
UT,2020,5,5,8.813285275,764,9.18152682256,727,8.99283698867,1491
UT,2020,5,6,10.82580516,770,14.8285355649,717,12.7558372382,1487
UT,2020,5,7,10.7704981,763,10.4710169492,708,10.6263562545,1471
UT,2020,5,8,15.34495619,686,10.1682255639,665,12.7968245347,1351
UT,2020,5,9,20.37462567,668,21.6688557994,638,21.006875917,1306
UT,2020,5,10,13.42459326,627,20.1572082019,634,16.8095876083,1261
UT,2020,5,11,10.80076495,706,8.02463223787,639,9.48184390684,1345
UT,2020,5,12,13.62204613,738,19.6789972527,728,16.6298636043,1466
UT,2020,5,13,8.310674784,652,15.3295695839,697,11.9371904812,1349
UT,2020,5,14,14.93605698,667,13.8090166667,600,14.4023362318,1267
UT,2020,5,15,15.27694121,680,14.9665248227,705,15.1189314244,1385
UT,2020,5,16,13.82327966,683,15.7178614458,664,14.7572086175,1347
UT,2020,5,17,12.96720663,716,24.7037181409,667,18.6275487687,1383
UT,2020,5,18,10.54568362,746,16.4069692737,716,13.4161901372,1462
UT,2020,5,19,12.83471818,763,15.9863950276,724,14.3692266115,1487
UT,2020,5,20,16.64869809,768,17.1444230769,728,16.8899332441,1496
UT,2020,5,21,14.50950381,786,14.7847150997,702,14.6393413943,1488
UT,2020,5,22,17.53320279,690,27.2979713914,769,22.6799519706,1459
UT,2020,5,23,18.99452027,615,20.6114915254,590,19.786232337,1205
UT,2020,5,24,23.90148794,625,17.0037359098,621,20.463683758,1246
UT,2020,5,25,18.0605336,656,23.9794753577,629,20.957821044,1285
UT,2020,5,26,14.41979051,716,16.329379616,677,15.3478535572,1393
UT,2020,5,27,12.37935141,740,26.5089423077,728,19.3863964873,1468
UT,2020,5,28,13.98813647,762,16.2772589532,726,15.1050067138,1488
UT,2020,5,29,17.58737761,797,16.7416755319,752,17.1768108168,1549
UT,2020,5,30,13.84262712,826,13.6469640788,863,13.7426524577,1689
UT,2020,5,31,22.5590395,760,22.5954071247,786,22.5775291203,1546
UT,2020,6,1,18.48642757,767,30.520794702,755,24.4561694784,1522
UT,2020,6,2,10.88415763,736,24.6367258883,788,17.9950656271,1524
UT,2020,6,3,12.38890839,742,18.6999328859,745,15.5507868362,1487
UT,2020,6,4,14.68145078,703,12.1769298246,684,13.4463445554,1387
UT,2020,6,5,13.97600293,678,16.3365625,672,15.1510370271,1350
UT,2020,6,6,16.84524244,660,14.6332568807,654,15.7442998557,1314
UT,2020,6,7,17.78765853,615,24.3843089431,615,21.0859837365,1230
UT,2020,6,8,13.45703706,648,24.1213752122,589,18.534882793,1237
UT,2020,6,9,12.29535093,684,23.271035503,676,17.7509117913,1360
UT,2020,6,10,16.24104881,696,17.5649411765,680,16.8952979446,1376
UT,2020,6,11,10.96364161,681,16.955705968,687,13.972814281,1368
UT,2020,6,12,14.63809692,599,12.799675425,647,13.6834751646,1246
UT,2020,6,13,21.66286236,559,29.3346557377,610,25.6661078351,1169
UT,2020,6,14,17.67117358,622,27.9052951096,593,22.6660987381,1215
UT,2020,6,15,17.69990967,663,15.6625039872,627,16.7096357451,1290
UT,2020,6,16,14.06946026,704,25.4734330709,635,19.4776176423,1339
UT,2020,6,17,15.23931239,727,15.2595815296,693,15.2492043011,1420
UT,2020,6,18,19.83502044,737,21.2769827586,696,20.5353733875,1433
UT,2020,6,19,17.59297223,683,20.4244334278,706,19.0321454522,1389
UT,2020,6,20,23.48151421,667,24.3113513514,666,23.8961215139,1333
UT,2020,6,21,23.4918314,688,24.6234776335,693,24.059703116,1381
UT,2020,6,22,18.33215605,705,27.8102457757,651,22.8824778874,1356
UT,2020,6,23,17.64908965,714,20.5420839161,715,19.0965990274,1429
UT,2020,6,24,17.03277048,758,23.0504754829,673,19.8629000865,1431
UT,2020,6,25,16.53473817,764,27.6829083665,753,22.0684047211,1517
UT,2020,6,26,19.69869195,711,25.1225774648,710,22.4087262325,1421
UT,2020,6,27,19.6637536,674,26.7668148148,675,23.217916921,1349
UT,2020,6,28,25.59164551,711,32.24375,688,28.86301641,1399
UT,2020,6,29,21.69153432,743,20.8174776119,670,21.2770842178,1413
UT,2020,6,30,16.22482612,690,24.7532222222,720,20.5797517892,1410
UT,2020,7,1,17.56206357,693,27.6135422343,734,22.7322004583,1427
UT,2020,7,2,21.74760301,655,25.6411349693,652,23.6899005138,1307
UT,2020,7,3,23.50054204,664,27.7389473684,646,25.590625889,1310
UT,2020,7,4,17.91902798,679,23.2690345821,694,20.6232556434,1373
UT,2020,7,5,21.47031916,658,26.9628687196,617,24.1282823587,1275
UT,2020,7,6,19.88409135,721,28.5199266862,682,24.0819813709,1403
UT,2020,7,7,20.21655026,745,26.3128654971,684,23.1345905834,1429
UT,2020,7,8,17.89591211,751,17.5800409277,733,17.7398921797,1484
UT,2020,7,9,26.04283263,752,21.4059160839,715,23.7828494463,1467
UT,2020,7,10,24.94463402,697,24.9813220816,711,24.9631604488,1408
UT,2020,7,11,18.28843079,650,22.9511275964,674,20.6620392851,1324
UT,2020,7,12,17.79375757,652,23.7530044843,669,20.8117259165,1321
UT,2020,7,13,19.60797693,692,22.1085511811,635,20.8045591828,1327
UT,2020,7,14,16.98816083,734,32.538838897,689,24.5176177437,1423
UT,2020,7,15,18.51253641,757,18.4538367347,735,18.4836193448,1492
UT,2020,7,16,20.96507425,741,24.5520360111,722,22.7352631711,1463
UT,2020,7,17,19.00780778,707,41.9705865522,699,30.4238692037,1406
UT,2020,7,18,21.66928574,672,24.8274506829,659,23.232945167,1331
UT,2020,7,19,24.76051008,647,25.9019349315,584,25.3020146399,1231
UT,2020,7,20,19.54945056,710,24.6337463127,678,22.0329898398,1388
UT,2020,7,21,20.32097519,728,30.4412556732,661,25.1370337929,1389
UT,2020,7,22,17.91787886,759,18.3522253129,719,18.1291745973,1478
UT,2020,7,23,25.44233607,732,36.9126104418,747,31.2356389474,1479
UT,2020,7,24,17.03502281,657,29.7174422188,649,23.3373889634,1306
UT,2020,7,25,22.37789148,626,32.3293097913,623,27.3416493727,1249
UT,2020,7,26,17.98426936,616,37.0460658307,638,27.6823763363,1254
UT,2020,7,27,23.2195434,679,40.5993874426,653,31.7398423188,1332
UT,2020,7,28,17.04521807,688,20.6846969697,660,18.8271587776,1348
UT,2020,7,29,15.45291892,764,25.9947743814,687,20.4441351171,1451
UT,2020,7,30,21.3097403,770,26.1518639456,735,23.6744983595,1505
UT,2020,7,31,23.7062048,635,24.5255028736,696,24.1346281352,1331
VA,2020,1,1,26.03981109,2911,36.1133035407,2909,31.0748264747,5820
VA,2020,1,2,19.83056131,2886,34.79734913,2701,27.0661607196,5587
VA,2020,1,3,21.24056673,2929,31.7853279786,2988,26.5655196809,5917
VA,2020,1,4,18.86217077,2916,32.8983987915,2979,25.9552875259,5895
VA,2020,1,5,22.35093489,2749,28.4331331953,2898,25.4722755468,5647
VA,2020,1,6,16.08336944,2956,34.5102768549,2709,24.8951068075,5665
VA,2020,1,7,14.37838965,3049,25.596576087,3128,20.0592196929,6177
VA,2020,1,8,15.68194266,3001,29.4390993236,2809,22.3332082483,5810
VA,2020,1,9,17.6708339,3010,32.0701906412,2885,24.7178473349,5895
VA,2020,1,10,18.23080551,2843,34.5028691557,2973,26.5486949905,5816
VA,2020,1,11,17.56322742,2801,26.8574893918,2828,22.2326487837,5629
VA,2020,1,12,20.90266982,2843,32.3520278472,2801,26.5847484582,5644
VA,2020,1,13,17.70416364,3055,29.5728480589,2988,23.572710561,6043
VA,2020,1,14,15.06721605,2500,28.0755752817,2929,22.0853564423,5429
VA,2020,1,15,16.98209678,2399,24.6410585366,2050,20.5111755845,4449
VA,2020,1,16,19.15125285,3065,29.2075504425,2825,23.9745195221,5890
VA,2020,1,17,21.97608646,2867,35.3321045621,3003,28.8088159933,5870
VA,2020,1,18,16.77391383,2808,25.2408629989,2781,20.9869368464,5589
VA,2020,1,19,21.45287035,2923,29.2081714286,2800,25.2471815539,5723
VA,2020,1,20,21.29032211,3012,33.624282345,2968,27.4119264541,5980
VA,2020,1,21,13.13908591,3063,29.8101807024,2933,21.2939092966,5996
VA,2020,1,22,13.47705977,3095,26.6207627688,2976,19.920093887,6071
VA,2020,1,23,17.58515647,3099,31.6381014348,2997,24.4940600231,6096
VA,2020,1,24,19.40002416,2897,32.6442833333,3000,26.1378192287,5897
VA,2020,1,25,17.26858341,2972,28.4959704185,2772,22.6868140485,5744
VA,2020,1,26,17.68290321,3007,28.4507365868,3299,23.3161227327,6306
VA,2020,1,27,14.47043805,2922,26.7217973022,2743,20.4025613384,5665
VA,2020,1,28,14.2078677,2992,24.5817807263,2864,19.2814481145,5856
VA,2020,1,29,15.65102348,3068,24.6226044226,2849,19.9707858774,5917
VA,2020,1,30,16.13210446,3103,28.6932194122,2926,22.2282766859,6029
VA,2020,1,31,19.10301963,2954,30.5690323614,3121,24.9936246892,6075
VA,2020,2,1,19.33817857,3080,35.226678153,2902,27.0460397853,5982
VA,2020,2,2,15.23118182,2107,26.5376213446,3317,22.1455365219,5424
VA,2020,2,3,17.31561365,1817,22.4885421836,1612,19.7474482362,3429
VA,2020,2,4,11.52210854,2784,25.0928039296,2443,17.8647924575,5227
VA,2020,2,5,12.27474697,2964,29.7153850971,3194,21.3207681096,6158
VA,2020,2,6,18.65793393,1452,27.722330168,2738,24.5811599204,4190
VA,2020,2,7,10.93802236,1517,10.3987581699,1071,10.7148570016,2588
VA,2020,2,8,20.90024897,2811,30.1964268503,2905,25.6247760418,5716
VA,2020,2,9,18.89690124,2643,29.559483008,2766,24.3494250282,5409
VA,2020,2,10,13.2613025,2787,27.6209358082,2586,20.1725274646,5373
VA,2020,2,11,12.76611517,2744,24.4845371987,2863,18.7496789774,5607
VA,2020,2,12,14.48222845,2827,27.4559814591,2481,20.5462603293,5308
VA,2020,2,13,18.77812633,3325,34.7463671128,3138,26.531234728,6463
VA,2020,2,14,20.88775204,2976,34.6660741206,3184,28.0095341024,6160
VA,2020,2,15,17.80334696,2695,26.1095529498,2729,21.9824834176,5424
VA,2020,2,16,20.20878832,2707,27.2626796407,2672,23.712784901,5379
VA,2020,2,17,17.84008831,2832,30.7640116478,2919,24.3998052676,5751
VA,2020,2,18,14.88282772,3112,29.3022426869,2769,21.6720404463,5881
VA,2020,2,19,14.74686431,3272,26.5044067278,3270,20.6238382792,6542
VA,2020,2,20,19.01508401,3094,26.12415,3000,22.5147883044,6094
VA,2020,2,21,18.13411434,2834,30.8281762504,2939,24.5965858374,5773
VA,2020,2,22,17.93060444,2829,30.2397836938,3606,24.8283356582,6435
VA,2020,2,23,18.42779446,2793,31.9511350018,2837,25.2423090456,5630
VA,2020,2,24,17.63803549,3044,32.9972667131,2872,25.0943762731,5916
VA,2020,2,25,14.6787809,3158,27.2866891675,3111,20.9354729753,6269
VA,2020,2,26,17.59212036,3108,26.5696997999,2998,22.0000442317,6106
VA,2020,2,27,21.41869682,3123,33.8788640974,2958,27.4797352687,6081
VA,2020,2,28,23.00838795,2990,33.61389,3000,28.3199916478,5990
VA,2020,2,29,23.64055166,2828,33.4433277254,2972,28.6636293266,5800
VA,2020,3,1,26.74750725,2792,41.3166412795,2626,33.8088852422,5418
VA,2020,3,2,17.54676418,3078,29.8658283079,2819,23.4357656683,5897
VA,2020,3,3,15.1191192,3145,27.0176516573,3198,21.1180955201,6343
VA,2020,3,4,17.32020638,3053,28.2776209677,2976,22.7289417944,6029
VA,2020,3,5,19.62187439,3105,29.9211155247,3021,24.700883118,6126
VA,2020,3,6,24.3193857,2898,34.884071876,3033,29.7219642149,5931
VA,2020,3,7,20.30201882,2769,31.3501675579,2805,25.8617707414,5574
VA,2020,3,8,25.08717227,2663,30.9476884807,2613,27.9896606814,5276
VA,2020,3,9,17.75361908,2777,32.9344130926,2658,25.1778234011,5435
VA,2020,3,10,15.96579589,3066,28.4571498599,2856,21.9899949677,5922
VA,2020,3,11,17.06145017,3510,28.653054878,3280,22.660929322,6790
VA,2020,3,12,17.9129395,3555,31.6140910368,3559,24.7673671524,7114
VA,2020,3,13,17.34995229,3143,29.1750308452,3242,23.3541660215,6385
VA,2020,3,14,16.22270597,3034,24.2421915474,2934,20.1652613795,5968
VA,2020,3,15,16.80439791,3197,22.8167460573,3107,19.7676538893,6304
VA,2020,3,16,10.53702286,3500,22.7226241999,3281,16.4330496992,6781
VA,2020,3,17,9.628428076,3537,19.9041457793,3471,14.7178995583,7008
VA,2020,3,18,9.226695331,3492,20.0809941349,3410,14.5893668641,6902
VA,2020,3,19,8.610422514,3550,17.1630236635,3423,12.8088383658,6973
VA,2020,3,20,8.328507116,3376,15.6857007739,3489,12.067654774,6865
VA,2020,3,21,8.743252843,3231,16.8152824333,3222,12.7736386077,6453
VA,2020,3,22,7.04959975,3248,12.5707795958,3117,9.75337313244,6365
VA,2020,3,23,5.793582792,3461,12.6681868452,3436,9.2184254086,6897
VA,2020,3,24,6.62904941,3482,15.4832983823,3338,10.9626979539,6820
VA,2020,3,25,7.608186848,3436,15.8686039633,3381,11.705072614,6817
VA,2020,3,26,6.85229313,3432,17.2621961245,3406,12.0374539371,6838
VA,2020,3,27,8.35016172,3153,16.0219429429,3330,12.2907804879,6483
VA,2020,3,28,6.581659676,3097,18.5103768506,2972,12.4231735074,6069
VA,2020,3,29,6.421299098,3233,13.8302620646,3129,10.0652231977,6362
VA,2020,3,30,4.702538283,3329,14.3229901522,3351,9.52860627906,6680
VA,2020,3,31,5.644240979,3320,13.2902982681,3118,9.34731749771,6438
VA,2020,4,1,5.623364256,3344,15.0274484223,3296,10.2914156735,6640
VA,2020,4,2,6.176293111,3248,16.5016260677,3161,11.2688781439,6409
VA,2020,4,3,7.321846194,3082,15.9618111215,3219,11.7357562244,6301
VA,2020,4,4,8.304109452,2942,15.0723074266,2895,11.6609593983,5837
VA,2020,4,5,6.021272982,2883,16.1991806723,2856,11.0862850683,5739
VA,2020,4,6,4.181092622,3066,14.8611959459,2960,9.42721041803,6026
VA,2020,4,7,3.904142219,3136,15.2285662009,3006,9.44650928017,6142
VA,2020,4,8,4.513906866,2813,15.653826087,3105,10.3586938179,5918
VA,2020,4,9,5.512734349,2699,16.3284170654,2508,10.7222085669,5207
VA,2020,4,10,5.285841403,2787,14.4613287671,2920,9.98050113723,5707
VA,2020,4,11,5.218204294,2712,13.7097362472,2654,9.41807865176,5366
VA,2020,4,12,6.277361047,2717,14.1313277693,2636,10.1449224668,5353
VA,2020,4,13,4.493823018,2825,13.1496280246,2769,8.77840007613,5594
VA,2020,4,14,3.885338815,2922,14.9267415342,2894,9.37946183243,5816
VA,2020,4,15,4.600995056,2844,16.7150345304,2896,10.712886749,5740
VA,2020,4,16,5.404429474,2892,14.7297070524,2765,9.96239173392,5657
VA,2020,4,17,5.571119822,2688,17.2062349611,2826,11.5342745886,5514
VA,2020,4,18,4.663005425,2582,12.1876544146,2639,8.46640490468,5221
VA,2020,4,19,5.204944646,2528,14.9931377953,2540,10.1106294525,5068
VA,2020,4,20,4.555110536,2669,15.902571977,2605,10.1599905234,5274
VA,2020,4,21,5.197952829,2755,15.1527442207,2682,10.1085194122,5437
VA,2020,4,22,5.629621136,2956,17.8392491103,2810,11.5798560663,5766
VA,2020,4,23,5.472860076,2958,17.759267727,3018,11.6777426548,5976
VA,2020,4,24,5.161754052,2651,14.8223729993,2874,10.1870244329,5525
VA,2020,4,25,5.847529911,2506,13.6304400786,2545,9.76903186636,5051
VA,2020,4,26,6.445605039,2405,16.9290912915,2377,11.6566562356,4782
VA,2020,4,27,6.434698648,2605,16.222000815,2454,11.1822850322,5059
VA,2020,4,28,4.884777147,2625,13.6004165014,2521,9.15452584743,5146
VA,2020,4,29,6.836258249,2734,14.3095713172,2566,10.4544698213,5300
VA,2020,4,30,7.965461418,2785,16.1789618875,2755,12.0499729331,5540
VA,2020,5,1,7.096409254,2551,20.7739450817,2877,14.3459064125,5428
VA,2020,5,2,5.830786255,2442,15.9767048242,2446,10.9078968974,4888
VA,2020,5,3,6.606405387,2437,17.0520057307,2443,11.8356270345,4880
VA,2020,5,4,5.892792686,2725,15.5793661972,2698,10.7119657144,5423
VA,2020,5,5,5.678248452,2632,17.2205996276,2685,11.5069512743,5317
VA,2020,5,6,5.739946059,2596,16.5777438541,2522,11.0804943277,5118
VA,2020,5,7,7.371409224,2654,17.1220620928,2609,12.2050503668,5263
VA,2020,5,8,9.644807185,2438,21.5243461237,2554,15.7226001436,4992
VA,2020,5,9,8.247913646,2363,16.9011339324,2337,12.5505893501,4700
VA,2020,5,10,6.978061903,2358,15.876898575,2386,11.4537415614,4744
VA,2020,5,11,6.427090254,2416,18.316588084,2333,12.2679406304,4749
VA,2020,5,12,6.796847318,2528,13.9124880763,2516,10.3462034139,5044
VA,2020,5,13,7.168846334,2297,18.6699879276,2485,13.1454956146,4782
VA,2020,5,14,6.889678022,2360,14.8716568047,2197,10.7379131297,4557
VA,2020,5,15,9.836500191,2483,21.7753373768,2638,15.9865983156,5121
VA,2020,5,16,9.053999131,2323,21.6818620116,2406,15.4787481458,4729
VA,2020,5,17,6.899365174,2347,16.1968561434,2287,11.4879197375,4634
VA,2020,5,18,6.444260436,2488,19.4223754789,2349,12.7468430773,4837
VA,2020,5,19,6.120236603,2536,20.1481135987,2412,12.9584013794,4948
VA,2020,5,20,6.573424133,2570,18.5919384864,2471,12.4646657453,5041
VA,2020,5,21,11.28432127,2534,18.8494210944,2522,15.0578936112,5056
VA,2020,5,22,11.10294116,2363,23.0089507409,2497,17.2200822965,4860
VA,2020,5,23,10.63021278,2256,22.5202201122,2317,16.6545178289,4573
VA,2020,5,24,10.55476697,2253,21.0312139738,2290,15.8356526488,4543
VA,2020,5,25,12.53807224,2324,25.5916380449,2271,18.9895734245,4595
VA,2020,5,26,9.915582639,2420,18.8048776441,2411,14.351949904,4831
VA,2020,5,27,7.883420664,2482,20.0584346754,2434,13.9114890334,4916
VA,2020,5,28,8.10710543,2598,17.2495798979,2547,12.6330301083,5145
VA,2020,5,29,10.37490188,2599,21.8091562729,2726,16.2283812181,5325
VA,2020,5,30,9.639391091,2529,17.2107916503,2539,13.4325611818,5068
VA,2020,5,31,11.28057233,2586,17.9265345025,2623,14.6271568526,5209
VA,2020,6,1,8.487671737,2693,25.4243720594,2763,17.0646700857,5456
VA,2020,6,2,6.055092477,2704,16.5692655572,2764,11.3698646777,5468
VA,2020,6,3,7.044843179,2519,20.5868438538,2709,14.0619204223,5228
VA,2020,6,4,8.967378426,2529,22.9036817289,2545,15.957502964,5074
VA,2020,6,5,11.57771232,2343,21.2417700157,2548,16.6122694675,4891
VA,2020,6,6,11.2668049,2194,17.5635759209,2226,14.4379841517,4420
VA,2020,6,7,11.50586307,2103,21.1655626424,2195,16.439097263,4298
VA,2020,6,8,10.11579256,2227,20.6727238806,2144,15.2940265457,4371
VA,2020,6,9,8.931489512,2343,20.3155746879,2323,14.5991341463,4666
VA,2020,6,10,7.904589337,2423,20.7659581453,2437,14.3537983464,4860
VA,2020,6,11,11.28010167,2360,23.3464720294,2449,17.4249428033,4809
VA,2020,6,12,14.19960613,2234,22.040411419,2382,18.2457062596,4616
VA,2020,6,13,11.32897428,2135,24.7114560827,2129,18.0107997392,4264
VA,2020,6,14,13.07444078,2146,21.8528360875,2239,17.5567274604,4385
VA,2020,6,15,9.773088961,2292,21.4690493114,2251,15.5682918553,4543
VA,2020,6,16,8.206325505,2433,22.9633047945,2336,15.4347389293,4769
VA,2020,6,17,9.444347608,2399,20.3562332215,2384,14.8831799941,4783
VA,2020,6,18,12.01354922,2502,21.5347605403,2443,16.717354934,4945
VA,2020,6,19,11.85227292,2367,26.7450426656,2461,19.4436371172,4828
VA,2020,6,20,15.1240807,2328,21.0651239669,2299,18.075984411,4627
VA,2020,6,21,15.49558232,2284,30.9884169884,2331,23.3208905783,4615
VA,2020,6,22,10.06943862,2298,24.8106892068,2307,17.4544690442,4605
VA,2020,6,23,9.186797555,2317,23.3836680672,2380,16.380442822,4697
VA,2020,6,24,9.868803997,2316,22.3674189189,2220,15.9858509826,4536
VA,2020,6,25,12.51107935,2307,22.4452836726,2309,17.4803336353,4616
VA,2020,6,26,13.83183755,2204,21.397971078,2282,17.6806821133,4486
VA,2020,6,27,12.21935325,2242,22.1945310376,2207,17.1677050992,4449
VA,2020,6,28,14.48128046,2257,22.9071365639,2270,18.7063066044,4527
VA,2020,6,29,11.90064957,2340,25.6120017294,2313,18.7165441637,4653
VA,2020,6,30,9.941757418,2259,24.8916708543,2388,17.6242177765,4647
VA,2020,7,1,12.42631942,2323,30.7922354879,2429,21.8141161643,4752
VA,2020,7,2,15.60493069,2310,26.5106880138,2311,21.0589893733,4621
VA,2020,7,3,12.36606774,2304,28.5670116934,2309,20.4753197644,4613
VA,2020,7,4,14.47562858,2235,23.835047993,2292,19.2142610727,4527
VA,2020,7,5,19.04503213,2178,26.7793507109,2110,22.8508652004,4288
VA,2020,7,6,12.12798984,2363,24.5497719298,2280,18.2278526797,4643
VA,2020,7,7,9.317330842,2394,21.0153,2400,15.1736358022,4794
VA,2020,7,8,10.17125102,2446,24.3635996671,2403,17.2044978336,4849
VA,2020,7,9,12.01422112,2478,22.5652159871,2477,17.2886538719,4955
VA,2020,7,10,11.77253686,2306,26.1155398083,2399,19.0857917108,4705
VA,2020,7,11,11.88850381,2239,20.9848766263,2229,16.4265107499,4468
VA,2020,7,12,12.84887489,2222,23.5155590062,2254,18.2203462926,4476
VA,2020,7,13,11.560784,2347,24.7875683761,2340,18.1642991355,4687
VA,2020,7,14,8.512079711,2433,23.4043205128,2340,15.8131154278,4773
VA,2020,7,15,9.437916278,2414,25.6513579246,2467,17.6326633672,4881
VA,2020,7,16,11.5637025,2393,24.1867508418,2376,17.8527280525,4769
VA,2020,7,17,15.92728625,2281,22.6191192583,2373,19.3393446361,4654
VA,2020,7,18,14.63674192,2259,23.9841876629,2302,19.3545275153,4561
VA,2020,7,19,17.0551712,2307,26.7603641208,2252,21.8492256983,4559
VA,2020,7,20,12.78177587,2427,24.2032671175,2366,18.419841443,4793
VA,2020,7,21,9.307463465,2464,20.4819755171,2369,14.7848934363,4833
VA,2020,7,22,11.03720221,2527,20.9849172386,2477,15.9613609082,5004
VA,2020,7,23,12.18388221,2563,21.9148510638,2585,17.0701593054,5148
VA,2020,7,24,16.34859488,2377,25.3555578259,2447,20.9174253793,4824
VA,2020,7,25,14.88470241,2218,24.1721528998,2276,19.5883600234,4494
VA,2020,7,26,14.80462171,2181,25.403285516,2161,20.0795439773,4342
VA,2020,7,27,10.8305,2300,24.4161510791,2224,17.5092108753,4524
VA,2020,7,28,9.011737926,2457,19.6598732625,2446,14.3238609187,4903
VA,2020,7,29,10.66335799,2433,25.703695742,2419,18.16182811,4852
VA,2020,7,30,14.10223131,2353,23.7844880264,2422,19.0133152403,4775
VA,2020,7,31,14.25550798,2195,28.5816052061,2305,21.5936533369,4500
VT,2020,1,1,37.6764897,94,21.0006060606,99,29.1225390249,193
VT,2020,1,2,28.92549471,91,40.8233636364,110,35.4367662617,201
VT,2020,1,3,35.62444416,81,16.0945238095,84,25.6819392543,165
VT,2020,1,4,25.64059565,84,30.916,95,28.4403912547,179
VT,2020,1,5,25.6367861,84,22.9676767677,99,24.1928417071,183
VT,2020,1,6,19.10494631,93,20.6694382022,89,19.8700000375,182
VT,2020,1,7,26.98830004,100,25.6892708333,96,26.3520408367,196
VT,2020,1,8,61.33817274,104,34.1221686747,83,49.2583420586,187
VT,2020,1,9,33.9506978,86,31.5841584158,101,32.6725134267,187
VT,2020,1,10,29.02866673,90,21.7116304348,92,25.3299450863,182
VT,2020,1,11,32.24295487,88,15.9651162791,86,24.197586371,174
VT,2020,1,12,32.67092806,97,15.4745054945,91,24.3471277756,188
VT,2020,1,13,34.75366302,101,34.8325471698,106,34.794057802,207
VT,2020,1,14,10.33094102,85,41.8137142857,105,27.7293157195,190
VT,2020,1,15,16.81662503,80,27.9951515152,66,21.8699315233,146
VT,2020,1,16,37.77301063,93,15.1928282828,99,26.1301041072,192
VT,2020,1,17,43.99609078,110,11.9126470588,102,28.5597169142,212
VT,2020,1,18,26.33056065,107,27.3598319328,119,26.8725220777,226
VT,2020,1,19,35.87782206,101,24.6803030303,99,30.3350501403,200
VT,2020,1,20,37.79918879,111,22.4501923077,104,30.3745579334,215
VT,2020,1,21,22.00019588,102,7.32082568807,109,14.4170141221,211
VT,2020,1,22,25.30252264,111,18.2978378378,111,21.8001802389,222
VT,2020,1,23,34.32324127,108,20.4894444444,108,27.4063428572,216
VT,2020,1,24,13.33277244,101,29.0861,100,21.170248838,201
VT,2020,1,25,13.11244176,86,13.6658585859,99,13.4085945479,185
VT,2020,1,26,27.04931045,87,60.4322222222,99,44.8176344578,186
VT,2020,1,27,25.89877818,90,18.0087878788,99,21.7659261175,189
VT,2020,1,28,18.93315207,92,37.7457647059,85,27.9674575731,177
VT,2020,1,29,45.03363592,88,35.427979798,99,39.9482885613,187
VT,2020,1,30,35.51107808,102,43.9826666667,105,39.8082606964,207
VT,2020,1,31,20.23051734,116,20.1243362832,113,20.1781223207,229
VT,2020,2,1,55.27749966,100,16.1448148148,108,34.9586056058,208
VT,2020,2,2,30.81620685,58,18.5594392523,107,22.8678787715,165
VT,2020,2,3,17.3206,50,6.15045454545,44,12.0920212766,94
VT,2020,2,4,27.88752809,89,13.1207894737,76,21.0858787879,165
VT,2020,2,5,16.2028973,107,12.866754386,114,14.4819910005,221
VT,2020,2,6,15.86600009,40,15.6138202247,89,15.6920155318,129
VT,2020,2,7,13.56080007,50,1.7696969697,33,8.87277112651,83
VT,2020,2,8,27.96514265,105,21.7246491228,114,24.7166665674,219
VT,2020,2,9,26.71244474,90,31.1036190476,105,29.0769232133,195
VT,2020,2,10,17.12511122,90,45.2536470588,85,30.7875429131,175
VT,2020,2,11,22.08076958,91,18.0247474747,99,19.9673685883,190
VT,2020,2,12,37.97602312,88,28.0693406593,91,32.9396649975,179
VT,2020,2,13,25.21196525,117,17.2926595745,94,21.6839333377,211
VT,2020,2,14,30.71754253,118,22.42312,125,26.4508642738,243
VT,2020,2,15,32.4001889,106,25.642892562,121,28.7982820414,227
VT,2020,2,16,45.65704032,98,34.8031,100,40.1752522796,198
VT,2020,2,17,33.90381351,118,33.751559633,109,33.8307048202,227
VT,2020,2,18,23.79763388,131,27.885,116,25.7172066327,247
VT,2020,2,19,27.64238119,126,28.5565289256,121,28.0902025504,247
VT,2020,2,20,28.79528903,121,35.735785124,121,32.265537077,242
VT,2020,2,21,55.84945476,110,32.3465178571,112,43.9921172234,222
VT,2020,2,22,23.22510859,92,28.2886394558,147,26.3394978673,239
VT,2020,2,23,49.25393239,89,10.6056976744,86,30.2610856155,175
VT,2020,2,24,13.99638301,94,30.0013414634,82,21.4532386531,176
VT,2020,2,25,5.100531905,94,15.2962886598,97,10.2784816705,191
VT,2020,2,26,34.69989449,95,19.6170786517,89,27.4044020465,184
VT,2020,2,27,35.35654881,113,45.1464646465,99,39.9282547902,212
VT,2020,2,28,32.23631566,95,15.333364486,107,23.2827722163,202
VT,2020,2,29,37.68628846,97,49.6744444444,108,44.0019999055,205
VT,2020,3,1,30.82411798,102,15.3810227273,88,23.6715264945,190
VT,2020,3,2,47.29163978,122,23.8733333333,108,36.2952176224,230
VT,2020,3,3,21.73117178,128,37.0035664336,143,29.7900368555,271
VT,2020,3,4,54.16426277,122,65.3818965517,116,59.6316809157,238
VT,2020,3,5,40.78031512,127,94.5105825243,103,64.8421305228,230
VT,2020,3,6,27.11068385,117,29.13375,112,28.10013105,229
VT,2020,3,7,22.52391776,97,25.5409243697,119,24.18606492,216
VT,2020,3,8,18.1902325,86,25.5453409091,88,21.9100574425,174
VT,2020,3,9,28.99676171,105,20.2304210526,95,24.8327498977,200
VT,2020,3,10,14.50697248,109,38.4442574257,101,26.0196666682,210
VT,2020,3,11,30.80688003,125,12.0774528302,106,22.2124242587,231
VT,2020,3,12,41.26483021,147,22.5954263566,129,32.5389131916,276
VT,2020,3,13,29.09715509,116,20.7259398496,133,24.6257830941,249
VT,2020,3,14,32.38619487,113,25.328317757,107,28.9535000923,220
VT,2020,3,15,29.5857019,114,23.6153125,128,26.427809986,242
VT,2020,3,16,52.08620074,129,31.1224545455,110,42.4376146254,239
VT,2020,3,17,37.7054605,152,28.979296875,128,33.7163571286,280
VT,2020,3,18,59.19285781,140,59.3473484848,132,59.2678312257,272
VT,2020,3,19,54.37527423,146,40.9057971014,138,47.8302466112,284
VT,2020,3,20,64.7998625,145,27.78672,125,47.6641483796,270
VT,2020,3,21,74.58943099,123,85.7783606557,122,80.1610612725,245
VT,2020,3,22,54.45032973,121,130.03462963,108,90.0970737875,229
VT,2020,3,23,42.14868948,145,33.853203125,128,38.2592306762,273
VT,2020,3,24,43.53827585,145,32.6850381679,131,38.3869202835,276
VT,2020,3,25,44.962766,141,25.5272868217,129,35.6769259481,270
VT,2020,3,26,39.69529407,136,41.3473049645,141,40.5362093629,277
VT,2020,3,27,40.7923769,122,60.7525984252,127,50.9728914932,249
VT,2020,3,28,32.03000026,113,17.9045454545,99,25.4336793839,212
VT,2020,3,29,6.355545588,110,80.0380172414,116,44.1748673216,226
VT,2020,3,30,29.24458031,131,38.2687610619,113,33.4238115599,244
VT,2020,3,31,46.31386849,137,38.2267375887,141,42.2121222415,278
VT,2020,4,1,55.03784181,139,16.0022137405,131,36.0983333763,270
VT,2020,4,2,51.45303252,122,49.7428571429,119,50.6085890765,241
VT,2020,4,3,51.44752033,121,46.0614018692,107,48.9198243857,228
VT,2020,4,4,41.16366688,120,19.9069369369,111,30.9493940502,231
VT,2020,4,5,19.24345137,113,67.7831132075,106,42.7375342685,219
VT,2020,4,6,51.52279966,125,33.9759633028,109,43.3492733226,234
VT,2020,4,7,32.27664007,125,58.7843478261,115,44.9782500365,240
VT,2020,4,8,44.25764226,106,17.6963157895,95,31.7037814903,201
VT,2020,4,9,37.17079226,101,40.0533,100,38.6048757127,201
VT,2020,4,10,20.41784507,116,13.6103361345,119,16.9706384175,235
VT,2020,4,11,33.59157893,114,33.3714953271,107,33.4850226155,221
VT,2020,4,12,64.65900788,111,26.8194791667,96,47.1102409405,207
VT,2020,4,13,30.981282,117,55.223826087,115,42.998060319,232
VT,2020,4,14,31.43605284,114,33.0031111111,90,32.1274020773,204
VT,2020,4,15,33.36147809,115,59.4997894737,95,45.1859522874,210
VT,2020,4,16,19.77169597,112,9.06817307692,104,14.6181479104,216
VT,2020,4,17,25.4727525,109,25.1768807339,109,25.324816617,218
VT,2020,4,18,25.07968142,94,12.2028282828,99,18.4744562356,193
VT,2020,4,19,62.60833311,102,52.275,86,57.8813828576,188
VT,2020,4,20,48.85819011,116,7.08494949495,99,29.6230700128,215
VT,2020,4,21,36.877478,115,52.4030769231,104,44.2503651598,219
VT,2020,4,22,28.26637223,113,82.64,126,56.9319667866,239
VT,2020,4,23,33.89925241,107,35.0052272727,88,34.3983590147,195
VT,2020,4,24,33.78798139,109,24.0612173913,115,28.79433023,224
VT,2020,4,25,13.52170454,88,42.3166666667,84,27.5843604623,172
VT,2020,4,26,21.12494837,97,3.17963855422,83,12.8501666216,180
VT,2020,4,27,42.33165182,115,73.3658333333,96,56.4514690014,211
VT,2020,4,28,42.05698132,106,46.2900980392,102,44.1328366342,208
VT,2020,4,29,38.65194424,108,28.7,81,34.38682528,189
VT,2020,4,30,14.08018905,106,33.9347,100,23.7183011617,206
VT,2020,5,1,32.91154605,97,57.7688043478,92,45.011375486,189
VT,2020,5,2,31.40357858,95,12.3468421053,95,21.8752103426,190
VT,2020,5,3,38.04325707,86,67.0476404494,89,52.7940577601,175
VT,2020,5,4,12.91299057,107,33.1990625,96,22.5064038965,203
VT,2020,5,5,28.21273544,106,34.151588785,107,31.1961030828,213
VT,2020,5,6,29.51781282,96,18.9252808989,89,24.421946112,185
VT,2020,5,7,20.68938747,98,45.0593684211,95,32.6849739485,193
VT,2020,5,8,20.94799989,105,34.54,87,27.1068749398,192
VT,2020,5,9,37.40794129,102,88.4950515464,97,62.3096985507,199
VT,2020,5,10,15.63168437,95,48.7722368421,76,30.360818802,171
VT,2020,5,11,30.96115812,95,35.7085869565,92,33.2967915583,187
VT,2020,5,12,20.92715774,95,34.3936363636,88,27.4028414497,183
VT,2020,5,13,12.73670866,79,5.39186666667,75,9.15967522169,154
VT,2020,5,14,29.60619589,92,26.2094444444,72,28.1149391578,164
VT,2020,5,15,14.32433332,90,33.77,91,24.1008839713,181
VT,2020,5,16,31.0750001,80,13.95025,80,22.51262505,160
VT,2020,5,17,16.02202533,79,43.7994594595,74,29.4568627521,153
VT,2020,5,18,41.15333281,87,10.8884090909,88,25.9343997398,175
VT,2020,5,19,25.30272732,99,65.696097561,82,43.6024862137,181
VT,2020,5,20,6.374123786,97,17.959,90,11.949732659,187
VT,2020,5,21,21.00806795,88,19.6420987654,81,20.3533726604,169
VT,2020,5,22,11.9565433,81,38.084787234,94,25.9911428989,175
VT,2020,5,23,11.49864175,81,28.27,76,19.6172610303,157
VT,2020,5,24,17.11722914,83,12.8844736842,76,15.0940252743,159
VT,2020,5,25,19.94809511,84,9.25060240964,83,14.6313771811,167
VT,2020,5,26,13.2212347,81,62.0927272727,88,38.6691124893,169
VT,2020,5,27,26.44655255,87,6.95807692308,78,17.2338186173,165
VT,2020,5,28,18.48894188,104,36.4364705882,85,26.5605817752,189
VT,2020,5,29,9.431547729,84,6.53852941176,102,7.8450538131,186
VT,2020,5,30,9.792368274,76,8.44289855072,69,9.15020681948,145
VT,2020,5,31,10.45851844,81,31.6386486486,74,20.5703225396,155
VT,2020,6,1,7.046944548,72,27.667375,80,17.8998026806,152
VT,2020,6,2,22.32578301,83,11.884109589,73,17.4396153194,156
VT,2020,6,3,39.6730346,89,7.6977173913,92,23.420387179,181
VT,2020,6,4,21.41173942,92,20.5690909091,77,21.0278108085,169
VT,2020,6,5,6.128354513,79,38.6892941176,85,23.0044512593,164
VT,2020,6,6,1.450303054,66,7.80735294118,68,4.67626866839,134
VT,2020,6,7,5.575762574,59,37.9853030303,66,22.6879999349,125
VT,2020,6,8,16.4947695,65,7.27666666667,60,12.07008014,125
VT,2020,6,9,12.17855055,69,9.38509803922,51,10.9913332329,120
VT,2020,6,10,6.955301153,83,10.4451428571,70,8.5519607562,153
VT,2020,6,11,12.2823332,90,10.1953846154,78,11.3133927857,168
VT,2020,6,12,12.02445931,74,40.4346153846,78,26.6033551904,152
VT,2020,6,13,23.01147052,68,28.1217142857,70,25.6036231548,138
VT,2020,6,14,25.59729386,85,51.9141176471,68,37.2936599876,153
VT,2020,6,15,8.208250018,80,16.5097222222,72,12.1405263253,152
VT,2020,6,16,8.049638514,83,14.8444155844,77,11.3196249791,160
VT,2020,6,17,15.82371415,70,9.94137931034,87,12.5640763726,157
VT,2020,6,18,36.34988674,88,31.8843055556,72,34.340375207,160
VT,2020,6,19,25.72102576,78,16.2857647059,85,20.8007976029,163
VT,2020,6,20,6.455783125,83,11.1467073171,82,8.78703029924,165
VT,2020,6,21,10.76071412,70,23.1935064935,77,17.2731291728,147
VT,2020,6,22,18.35590849,88,9.12464788732,71,14.2337732523,159
VT,2020,6,23,24.72923049,78,9.71301369863,73,17.4697349551,151
VT,2020,6,24,21.05493514,77,20.144939759,83,20.5828750361,160
VT,2020,6,25,30.31804912,82,13.5088405797,69,22.6370200519,151
VT,2020,6,26,20.92633795,71,7.49513157895,76,13.9823128874,147
VT,2020,6,27,15.99365845,82,7.56857142857,77,11.913584861,159
VT,2020,6,28,15.49451244,82,47.0605263158,76,30.6781646841,158
VT,2020,6,29,31.5835225,88,12.5037804878,82,22.3803528235,170
VT,2020,6,30,25.97065766,76,24.1137681159,69,25.0870343597,145
VT,2020,7,1,9.046363613,77,25.7514285714,84,17.7620496783,161
VT,2020,7,2,15.87728398,81,13.7964197531,81,14.8368518665,162
VT,2020,7,3,3.775301199,83,38.2187912088,91,21.7888505719,174
VT,2020,7,4,18.5160496,81,19.0811392405,79,18.79506261,160
VT,2020,7,5,25.13675673,74,18.7052054795,73,21.9428571294,147
VT,2020,7,6,47.88477281,88,33.1236708861,79,40.9019760915,167
VT,2020,7,7,30.44113648,88,53.7221176471,85,41.8797688453,173
VT,2020,7,8,27.8298984,98,13.252,95,20.6542489285,193
VT,2020,7,9,6.886385585,83,18.8162921348,89,13.0594186253,172
VT,2020,7,10,9.061111021,81,13.7467032967,91,11.5401162366,172
VT,2020,7,11,17.1399998,71,16.9883544304,79,17.0601332387,150
VT,2020,7,12,18.58289484,76,15.1775,76,16.88019742,152
VT,2020,7,13,10.45152925,85,17.2456578947,76,13.6586955668,161
VT,2020,7,14,43.19958359,96,21.8558227848,79,33.5644001408,175
VT,2020,7,15,12.73954534,88,14.565,88,13.65227267,176
VT,2020,7,16,15.64818168,88,33.361,80,24.0828570705,168
VT,2020,7,17,17.01589039,73,13.541875,80,15.1994117547,153
VT,2020,7,18,16.85622214,90,15.259625,80,16.1048823094,170
VT,2020,7,19,19.95242111,95,43.7628571429,91,31.6016129325,186
VT,2020,7,20,21.14264405,87,28.604556962,79,24.6937953756,166
VT,2020,7,21,9.556483508,91,12.9322222222,90,11.23502762,181
VT,2020,7,22,14.31057135,105,28.3850515464,97,21.06910887,202
VT,2020,7,23,12.40323226,99,35.6010784314,102,24.1752736007,201
VT,2020,7,24,14.88090908,88,22.0093258427,89,18.4652542319,177
VT,2020,7,25,19.90183111,71,10.7575,72,15.2976923693,143
VT,2020,7,26,9.503972658,73,12.3174324324,74,10.9202721363,147
VT,2020,7,27,6.031011223,89,25.1586075949,79,15.0255357074,168
VT,2020,7,28,5.396543162,81,29.7170786517,89,18.1290588007,170
VT,2020,7,29,16.14184737,92,37.3406593407,91,26.683333104,183
VT,2020,7,30,17.78108924,101,24.5184821429,112,21.3237559307,213
VT,2020,7,31,27.76551252,78,14.7962820513,78,21.2808972856,156
WA,2020,1,1,38.52063168,2390,31.0198383542,2722,34.5266646548,5112
WA,2020,1,2,30.60282931,2354,28.363209713,2265,29.5045962753,4619
WA,2020,1,3,26.52750523,2405,29.3333495342,2469,27.9488490107,4874
WA,2020,1,4,24.81634025,2563,24.0129875352,2487,24.4207089229,5050
WA,2020,1,5,31.90289104,2487,17.9295050215,2788,24.5175260695,5275
WA,2020,1,6,30.9622616,2569,21.8153132938,2362,26.5807787569,4931
WA,2020,1,7,20.2038462,2587,29.1494061758,2526,24.6232642518,5113
WA,2020,1,8,23.38299296,2683,19.2612115154,2501,21.3944560401,5184
WA,2020,1,9,26.44909178,2764,24.5397015475,2714,25.5031105659,5478
WA,2020,1,10,31.862307,2540,32.3056158892,2744,32.0925188834,5284
WA,2020,1,11,24.854697,2574,30.3096206753,2399,27.4861793843,4973
WA,2020,1,12,32.47819005,2862,26.4156136129,2909,29.4222145076,5771
WA,2020,1,13,25.81521551,2876,35.0098874032,2842,30.3852150764,5718
WA,2020,1,14,16.68080221,2331,25.6485365854,2788,21.5649677577,5119
WA,2020,1,15,29.58997505,2003,17.6617412664,1832,23.8917940092,3835
WA,2020,1,16,30.80287146,2483,30.2883499547,2206,30.5608082395,4689
WA,2020,1,17,33.7333453,2520,30.718689082,2647,32.1889684838,5167
WA,2020,1,18,21.53139207,2507,26.1910609117,2479,23.8481427837,4986
WA,2020,1,19,35.89320767,2466,24.0613346457,2540,29.8898202386,5006
WA,2020,1,20,30.58123194,2484,29.5737336152,2365,30.0898453576,4849
WA,2020,1,21,26.42804151,2604,20.788859375,2560,23.6324748435,5164
WA,2020,1,22,22.75487223,2662,25.9088400771,2595,24.3117576329,5257
WA,2020,1,23,25.94731911,2667,32.6369420517,2554,29.2197376109,5221
WA,2020,1,24,34.23777041,2516,33.7566679492,2599,33.9933158068,5115
WA,2020,1,25,22.9518401,2527,26.635177665,2364,24.7321324745,4891
WA,2020,1,26,32.35250515,2443,26.3162164125,2754,29.153748332,5197
WA,2020,1,27,29.75496094,2427,27.7923337679,2301,28.799799112,4728
WA,2020,1,28,21.34285823,2596,19.1693464858,2433,20.2913263005,5029
WA,2020,1,29,21.9305033,2662,24.1681638306,2527,23.0202254355,5189
WA,2020,1,30,35.89416424,2728,24.3527322192,2573,30.2921826159,5301
WA,2020,1,31,35.1812646,2649,27.1672911392,2765,31.0884244413,5414
WA,2020,2,1,30.89104006,2769,37.3717785362,2637,34.0522881846,5406
WA,2020,2,2,30.02699998,1830,32.7332953064,3068,31.7221641412,4898
WA,2020,2,3,42.54091096,1548,19.1047969925,1330,31.7104621842,2878
WA,2020,2,4,21.20194445,2417,24.6631526391,2103,22.8123251628,4520
WA,2020,2,5,21.84468693,2492,25.1366166542,2666,23.5461767797,5158
WA,2020,2,6,39.94658997,1305,27.2003780069,2328,31.7789099672,3633
WA,2020,2,7,22.17521517,1394,9.78729330709,1016,16.9527551647,2410
WA,2020,2,8,23.77109962,2410,30.9515667466,2502,27.4285769715,4912
WA,2020,2,9,36.55457881,2339,20.2128839869,2448,28.1976811858,4787
WA,2020,2,10,23.81942992,2439,22.6307457479,2293,23.243425523,4732
WA,2020,2,11,23.91909864,2352,26.569991586,2377,25.2515521255,4729
WA,2020,2,12,33.52887884,2417,21.9025178147,2105,28.1167846431,4522
WA,2020,2,13,33.38245557,2753,31.0217070358,2601,32.2355921151,5354
WA,2020,2,14,34.91859764,2503,30.854130597,2680,32.8169631281,5183
WA,2020,2,15,31.15849972,2293,25.5434506754,2443,28.2620544464,4736
WA,2020,2,16,30.69041176,2283,29.0519501134,2205,29.8854189055,4488
WA,2020,2,17,34.77163814,2405,28.2735338983,2360,31.5532696174,4765
WA,2020,2,18,22.74925402,2574,20.0178957997,2476,21.4100771975,5050
WA,2020,2,19,27.02660484,2589,28.8072783346,2594,27.9178004883,5183
WA,2020,2,20,35.4011289,2498,20.3832384052,2458,27.9527885376,4956
WA,2020,2,21,34.71975293,2388,31.5037676349,2410,33.104387244,4798
WA,2020,2,22,29.28926292,2347,19.3858800393,3051,23.69177845,5398
WA,2020,2,23,37.53751339,2236,23.9854353339,2366,30.5700608301,4602
WA,2020,2,24,33.78119143,2409,35.8527034121,2286,34.7898125995,4695
WA,2020,2,25,24.54783187,2509,21.8397755511,2495,23.1975919588,5004
WA,2020,2,26,28.01445947,2507,33.6593851267,2407,30.7794851224,4914
WA,2020,2,27,32.50181565,2616,34.528509342,2462,33.4844308272,5078
WA,2020,2,28,31.15658185,2595,29.4691034212,2543,30.3213818413,5138
WA,2020,2,29,31.90015242,2428,29.1841369969,2584,30.499876312,5012
WA,2020,3,1,33.93603892,2310,28.2337198276,2320,31.0787213618,4630
WA,2020,3,2,24.76209062,2492,26.7973398388,2357,25.7513837544,4849
WA,2020,3,3,23.27618691,2620,20.8050555115,2522,22.0641695263,5142
WA,2020,3,4,23.38934739,2804,20.1426504673,2675,21.804219763,5479
WA,2020,3,5,26.59190167,2808,29.1530945347,2708,27.8492820684,5516
WA,2020,3,6,23.79777014,2601,24.2575598086,2717,24.032679604,5318
WA,2020,3,7,21.3703288,2402,20.2054918359,2511,20.7749887599,4913
WA,2020,3,8,29.98931415,2391,22.8333491175,2323,26.462944449,4714
WA,2020,3,9,24.5514648,2526,23.2559133791,2332,23.9295574485,4858
WA,2020,3,10,18.63673985,2779,22.0253650058,2589,20.2710823478,5368
WA,2020,3,11,20.74938154,3104,25.358125,2960,22.9990320416,6064
WA,2020,3,12,17.79024375,3281,18.9929714661,3049,18.3695671001,6330
WA,2020,3,13,16.0426987,3046,18.5008804246,3203,17.3026692655,6249
WA,2020,3,14,15.1749639,2905,19.4468776371,2844,17.2882571107,5749
WA,2020,3,15,13.8853715,2880,15.4358459374,2843,14.655596701,5723
WA,2020,3,16,11.35908193,3028,15.8370574404,2977,13.5790541356,6005
WA,2020,3,17,14.06305357,3098,13.0447808632,2989,13.5630343289,6087
WA,2020,3,18,11.40839912,3117,11.8386702849,2948,11.6175399929,6065
WA,2020,3,19,8.134432275,3188,12.0952311846,2963,10.0423898704,6151
WA,2020,3,20,8.835020868,3115,11.9768634921,3150,10.4147182767,6265
WA,2020,3,21,7.701795788,2957,13.5529898649,2960,10.6288761442,5917
WA,2020,3,22,9.592820595,2776,9.75198285102,2799,9.67273003977,5575
WA,2020,3,23,6.402950966,2999,9.54892669239,2851,7.93614358069,5850
WA,2020,3,24,8.06642496,3088,11.4658887381,2948,9.72673298152,6036
WA,2020,3,25,7.426213165,3050,13.4667295386,2969,10.4058265747,6019
WA,2020,3,26,7.438161063,3116,9.5545460548,3029,8.48137182625,6145
WA,2020,3,27,8.754806771,3002,13.2248911609,3032,11.0009612076,6034
WA,2020,3,28,7.711025839,2895,19.1158741745,2877,13.3956669792,5772
WA,2020,3,29,6.80587472,2841,13.4576368159,2814,10.1158762298,5655
WA,2020,3,30,5.767606104,2874,11.617723607,2728,8.61643162137,5602
WA,2020,3,31,6.145886096,2985,13.4707533287,2854,9.72615173772,5839
WA,2020,4,1,7.349230781,3016,13.4692698192,2876,10.3365410787,5892
WA,2020,4,2,5.154847834,2859,17.088313253,2822,11.0827195841,5681
WA,2020,4,3,7.908305536,2756,11.0852439887,2828,9.51725645724,5584
WA,2020,4,4,6.2197816,2656,12.7678587361,2690,9.51464271036,5346
WA,2020,4,5,6.799436761,2610,17.1107296979,2549,11.8941228816,5159
WA,2020,4,6,4.548402673,2692,14.2128917051,2604,9.30035309587,5296
WA,2020,4,7,5.652854126,2852,14.3453564621,2623,9.81731688901,5475
WA,2020,4,8,8.153835095,2644,14.0854378378,2775,11.1913323475,5419
WA,2020,4,9,12.69648402,2537,14.4268044789,2322,13.5233628234,4859
WA,2020,4,10,9.533626408,2559,13.0011609603,2541,11.2612745055,5100
WA,2020,4,11,7.231085838,2459,10.8067203635,2421,9.00498157288,4880
WA,2020,4,12,5.120515464,2425,12.3435628866,2425,8.7320391753,4850
WA,2020,4,13,5.27453142,2529,12.6430672269,2380,8.846972899,4909
WA,2020,4,14,4.765240442,2641,8.60076513912,2444,6.60870599947,5085
WA,2020,4,15,4.680810406,2690,9.5968740458,2620,7.10643879325,5310
WA,2020,4,16,6.168510913,2599,9.71853706625,2536,7.92174680874,5135
WA,2020,4,17,7.262952392,2459,10.4893844924,2502,8.89015116548,4961
WA,2020,4,18,4.614236899,2431,13.8283823529,2448,9.23736214418,4879
WA,2020,4,19,5.81792981,2338,10.683381725,2342,8.25273502047,4680
WA,2020,4,20,8.838120361,2410,10.9093542757,2292,9.8477477818,4702
WA,2020,4,21,6.48385461,2545,13.1830369718,2272,9.64361012714,4817
WA,2020,4,22,7.701242757,2583,15.8154605535,2421,11.6270064031,5004
WA,2020,4,23,8.35351089,2703,12.9619516946,2567,10.59826754,5270
WA,2020,4,24,5.083688894,2475,10.2825866237,2482,7.68680855611,4957
WA,2020,4,25,5.779665326,2271,14.3951309122,2368,10.1774714282,4639
WA,2020,4,26,7.233619977,2221,8.19581637268,2211,7.71363266447,4432
WA,2020,4,27,6.22405118,2266,11.5248807854,2139,8.79805220746,4405
WA,2020,4,28,7.021269195,2277,14.4062488522,2178,10.6317036941,4455
WA,2020,4,29,9.243759355,2394,9.91523980278,2231,9.56766700451,4625
WA,2020,4,30,9.9094988,2454,12.2998862144,2285,11.0620700686,4739
WA,2020,5,1,7.001308003,2370,16.8591908397,2620,12.1771903742,4990
WA,2020,5,2,7.97229312,2272,10.205536036,2220,9.07598841688,4492
WA,2020,5,3,7.250637206,2197,11.4234093023,2150,9.31446513494,4347
WA,2020,5,4,9.229002107,2375,13.8384718499,2238,11.4652894004,4613
WA,2020,5,5,6.74676081,2371,9.93524246396,2289,8.31294847221,4660
WA,2020,5,6,6.494650226,2316,13.4603257474,2241,9.92016675958,4557
WA,2020,5,7,9.494685695,2386,14.7325661032,2307,12.0695397546,4693
WA,2020,5,8,9.204869245,2294,16.1804455017,2312,12.7062874616,4606
WA,2020,5,9,10.26432749,2223,11.7685881295,2224,11.0166269418,4447
WA,2020,5,10,11.1927111,2191,20.0078840054,2207,15.6163324284,4398
WA,2020,5,11,8.444346314,2241,11.8090626472,2123,10.0812145027,4364
WA,2020,5,12,6.881207776,2277,6.64023255814,2193,6.76298436375,4470
WA,2020,5,13,7.352019889,2114,8.81363345521,2188,8.09539750008,4302
WA,2020,5,14,10.07304548,2131,14.5491847006,1987,12.2328533069,4118
WA,2020,5,15,8.050930435,2214,13.7387027265,2274,10.932836449,4488
WA,2020,5,16,10.84220992,2172,14.6113131313,2178,12.7293609072,4350
WA,2020,5,17,11.53944099,2093,8.63715909091,2112,10.081743161,4205
WA,2020,5,18,8.440682063,2243,11.4238568773,2152,9.90138563534,4395
WA,2020,5,19,9.698208179,2277,11.7154529067,2219,10.6938189554,4496
WA,2020,5,20,7.94185406,2357,10.9061582168,2288,9.40198923992,4645
WA,2020,5,21,9.794305728,2283,11.4756394316,2252,10.6292260148,4535
WA,2020,5,22,8.516705606,2143,12.2065078671,2288,10.4219792628,4431
WA,2020,5,23,7.749090478,2078,15.5104598826,2044,11.597765651,4122
WA,2020,5,24,10.89582269,2042,16.2087043351,2053,13.559399251,4095
WA,2020,5,25,11.67292409,2028,17.5159259259,2025,14.592262535,4053
WA,2020,5,26,6.424309281,2179,12.5791761223,2027,9.39052779917,4206
WA,2020,5,27,7.200091403,2297,17.194032186,2237,12.1309351462,4534
WA,2020,5,28,11.12652556,2386,13.1421412804,2265,12.108114381,4651
WA,2020,5,29,9.971989437,2478,13.7684709231,2459,11.8629248177,4937
WA,2020,5,30,8.268714993,2568,15.5664303527,2807,12.0798195539,5375
WA,2020,5,31,13.22067944,2399,17.7686200156,2558,15.567589263,4957
WA,2020,6,1,8.286377818,2493,19.0594474922,2552,13.7359068187,5045
WA,2020,6,2,7.918488081,2434,9.95461754105,2497,8.94955992479,4931
WA,2020,6,3,6.57967673,2289,12.463688946,2334,9.550320146,4623
WA,2020,6,4,11.22902584,2279,14.9518570798,2267,13.0855279123,4546
WA,2020,6,5,10.78179127,2166,16.86404567,2321,13.9279718945,4487
WA,2020,6,6,8.034590011,2122,14.9797480531,2183,11.5563739845,4305
WA,2020,6,7,9.699971208,2085,15.006500679,2209,12.4298556052,4294
WA,2020,6,8,10.60807201,2085,16.6519751315,2091,13.6343654552,4176
WA,2020,6,9,12.0086873,2194,19.2631696015,2158,15.6059236986,4352
WA,2020,6,10,10.86288266,2293,20.2114733542,2233,15.4752120944,4526
WA,2020,6,11,11.44742054,2330,13.3245616212,2418,12.4033866593,4748
WA,2020,6,12,11.19999094,2190,18.6983684211,2280,15.0246667021,4470
WA,2020,6,13,10.02408182,2102,19.6245631068,2163,14.8929777223,4265
WA,2020,6,14,11.93028571,1995,11.4317369971,2038,11.6783535808,4033
WA,2020,6,15,16.47526191,2100,20.2525326877,2065,18.3480264132,4165
WA,2020,6,16,12.39715143,2159,18.1864105012,2095,15.2482322373,4254
WA,2020,6,17,10.09540378,2167,22.2080086166,2089,16.040711934,4256
WA,2020,6,18,17.0695494,2197,19.407027027,2183,18.2345525187,4380
WA,2020,6,19,17.78135508,2059,20.1910108303,2216,19.030430435,4275
WA,2020,6,20,20.16912793,2041,18.5040189125,2115,19.3217493034,4156
WA,2020,6,21,18.74780806,2012,26.1309887969,2053,22.4766321812,4065
WA,2020,6,22,12.9402156,2134,13.9275741627,2090,13.4287523888,4224
WA,2020,6,23,15.03863907,2241,12.6620596206,2214,13.8575511012,4455
WA,2020,6,24,13.07603034,2174,13.2890398126,2135,13.1815711207,4309
WA,2020,6,25,12.12177491,2186,20.1535697835,2171,16.1238466728,4357
WA,2020,6,26,13.2501909,2042,14.6372183588,2157,13.9626982181,4199
WA,2020,6,27,12.17611889,1935,17.4082539683,2079,14.8860363857,4014
WA,2020,6,28,15.16911502,2000,22.3310294118,1972,18.7248288117,3972
WA,2020,6,29,11.89174131,2142,10.1077036684,2099,11.0087667734,4241
WA,2020,6,30,12.34989923,2084,22.1744832402,2148,17.3364792049,4232
WA,2020,7,1,17.00901315,2128,24.4256272242,2248,20.819010508,4376
WA,2020,7,2,15.32270812,2042,20.0841033138,2052,17.7092208063,4094
WA,2020,7,3,17.28952647,2027,18.8825797239,2101,18.1003319173,4128
WA,2020,7,4,13.33732674,1934,16.2040271713,2061,14.8162427823,3995
WA,2020,7,5,22.520322,1832,22.0728900804,1865,22.2946091166,3697
WA,2020,7,6,12.35752386,2092,15.759969985,1999,14.020073311,4091
WA,2020,7,7,14.75739774,2225,14.4998577982,2180,14.6299432398,4405
WA,2020,7,8,12.55100315,2233,18.8193061773,2234,15.685856287,4467
WA,2020,7,9,12.91105826,2230,15.614652234,2171,14.244732997,4401
WA,2020,7,10,15.72563243,2040,19.5853665158,2210,17.7326941546,4250
WA,2020,7,11,12.65595116,1924,23.8361743952,1984,18.3318884421,3908
WA,2020,7,12,13.99819924,1988,13.8607271815,1994,13.9293596407,3982
WA,2020,7,13,10.84831824,2099,16.3214142929,2001,13.5194560941,4100
WA,2020,7,14,14.08104489,2163,13.1265186585,2117,13.6089112376,4280
WA,2020,7,15,10.8604239,2147,12.6660275862,2175,11.7690745288,4322
WA,2020,7,16,13.85379003,2161,14.0848868992,2122,13.9682863075,4283
WA,2020,7,17,14.36105448,2020,19.4777079482,2164,17.0074307002,4184
WA,2020,7,18,13.48644566,1961,15.3996136701,2019,14.456969834,3980
WA,2020,7,19,19.00182544,1983,18.7031449503,1911,18.855246494,3894
WA,2020,7,20,14.23626244,2210,19.6712257454,2113,16.8927689087,4323
WA,2020,7,21,10.86099776,2235,16.2218547282,2189,13.5135556043,4424
WA,2020,7,22,12.70201795,2463,15.4792675439,2280,14.0370651931,4743
WA,2020,7,23,14.42988773,2404,18.4342103143,2482,16.4640114824,4886
WA,2020,7,24,17.9972233,2132,17.464479346,2324,17.7193738949,4456
WA,2020,7,25,18.76752459,2036,16.4104064665,2165,17.5527755452,4201
WA,2020,7,26,13.66294232,2029,16.961102905,2031,15.3128349673,4060
WA,2020,7,27,14.99114214,2180,18.1269582119,2058,16.5139145505,4238
WA,2020,7,28,12.22840286,2254,19.3549614862,2207,15.7541403377,4461
WA,2020,7,29,11.8975829,2292,14.1963607737,2223,13.0294064245,4515
WA,2020,7,30,12.02664081,2307,14.1572407733,2276,13.0847349659,4583
WA,2020,7,31,10.78007649,1962,21.8960350877,2280,16.7547077024,4242
WI,2020,1,1,22.30622899,1196,33.6926077739,1415,28.4769398208,2611
WI,2020,1,2,18.39696965,1089,26.4172307692,1040,22.3148050488,2129
WI,2020,1,3,17.72906192,1130,27.0650403587,1115,22.3658619018,2245
WI,2020,1,4,14.53178507,1154,19.4936714976,1242,17.1038480679,2396
WI,2020,1,5,20.03715438,1107,19.8598995816,1195,19.9451389655,2302
WI,2020,1,6,19.11904309,1087,24.3125872093,1032,21.6484142703,2119
WI,2020,1,7,18.31249762,1077,22.120741784,1065,20.2059523514,2142
WI,2020,1,8,18.49987618,1050,26.9642249527,1058,22.7481119492,2108
WI,2020,1,9,16.55472479,1090,24.5519393382,1088,20.5496602484,2178
WI,2020,1,10,24.39888675,1069,24.9338309353,1112,24.6716322493,2181
WI,2020,1,11,22.78383891,1279,21.7389348592,1136,22.2923229672,2415
WI,2020,1,12,33.58842138,1305,25.0367316745,1487,29.033850251,2792
WI,2020,1,13,18.78191258,1166,43.3847886109,1159,31.0463140079,2325
WI,2020,1,14,18.16773345,878,25.661295972,1142,22.404193054,2020
WI,2020,1,15,15.80601979,809,29.4520117474,681,22.0428792014,1490
WI,2020,1,16,14.94839725,1042,23.344226601,1015,19.0912104689,2057
WI,2020,1,17,16.07260665,1078,32.5914632035,1155,24.6168427983,2233
WI,2020,1,18,19.38774683,1185,19.7252998236,1134,19.5528115539,2319
WI,2020,1,19,18.66413782,1160,23.7246870654,1438,21.4651654624,2598
WI,2020,1,20,22.36703371,1099,29.3720114395,1049,25.7879935043,2148
WI,2020,1,21,12.15092212,1041,21.6404630454,1123,17.0754851788,2164
WI,2020,1,22,17.58741159,1074,26.705626186,1054,22.1036701352,2128
WI,2020,1,23,17.65130668,1102,32.1199808978,1047,24.7004932347,2149
WI,2020,1,24,16.78379179,1047,27.2070698925,1116,22.1616828498,2163
WI,2020,1,25,18.25683885,1104,31.645234375,1024,24.6993750425,2128
WI,2020,1,26,11.94323167,1083,23.7764421553,1262,18.3114669077,2345
WI,2020,1,27,10.64822068,1006,23.9400715746,978,17.2003528246,1984
WI,2020,1,28,14.22583744,1021,24.8606086142,1068,19.6628578393,2089
WI,2020,1,29,12.55965611,1076,22.4537200384,1043,17.4296460474,2119
WI,2020,1,30,15.97239212,1112,20.3725113327,1103,18.1635124323,2215
WI,2020,1,31,20.53130236,1121,24.3465882353,1190,22.4959021833,2311
WI,2020,2,1,14.27527225,1212,23.2063864818,1154,18.6313609328,2366
WI,2020,2,2,16.02079338,731,22.0483357143,1400,19.9806991838,2131
WI,2020,2,3,13.65729686,603,15.2274259259,540,14.3990901195,1143
WI,2020,2,4,12.48242774,968,21.5283985765,843,16.6932247666,1811
WI,2020,2,5,20.36366314,1051,23.763580786,1145,22.1363888707,2196
WI,2020,2,6,19.66419111,513,24.8053917526,970,23.0269454076,1483
WI,2020,2,7,10.1460033,593,8.1470952381,420,9.31723589033,1013
WI,2020,2,8,12.8846388,1149,27.3796621005,1095,19.9577450897,2244
WI,2020,2,9,24.18806609,1029,20.8386522911,1113,22.4476844102,2142
WI,2020,2,10,12.66152497,1023,23.8843177189,982,18.1581745857,2005
WI,2020,2,11,14.84226376,963,21.5763480885,994,18.2626417991,1957
WI,2020,2,12,20.25276278,952,21.431024735,849,20.8082010919,1801
WI,2020,2,13,21.44581647,1133,23.4730193906,1083,22.4365478612,2216
WI,2020,2,14,21.71339499,1187,28.4064810127,1185,25.0571162956,2372
WI,2020,2,15,18.48837348,1119,23.0176419214,1145,20.7790149842,2264
WI,2020,2,16,23.90570608,1048,27.9003351449,1104,25.9549953401,2152
WI,2020,2,17,15.95980642,1085,25.5928145387,1073,20.7495273242,2158
WI,2020,2,18,13.23625542,1143,23.9918315018,1092,18.4913288345,2235
WI,2020,2,19,10.5704913,1140,27.9287744227,1126,19.1960106275,2266
WI,2020,2,20,18.27800728,1099,24.7673833486,1093,21.5138138689,2192
WI,2020,2,21,22.99346045,1075,31.3073961219,1083,27.165838732,2158
WI,2020,2,22,17.06167734,1097,28.9450794748,1447,23.820829419,2544
WI,2020,2,23,20.20977521,1023,32.6278896418,1033,26.4490321205,2056
WI,2020,2,24,17.46461404,1140,23.6441705717,1067,20.4521930247,2207
WI,2020,2,25,15.13289311,1151,21.1876882197,1129,18.131078934,2280
WI,2020,2,26,19.86405191,1155,21.8459647495,1078,20.8208374187,2233
WI,2020,2,27,21.10676743,1191,25.5133598585,1131,23.2531309256,2322
WI,2020,2,28,23.80657494,1127,31.0692393162,1170,27.5058859196,2297
WI,2020,2,29,19.91231298,1016,24.2795660036,1106,22.1885532458,2122
WI,2020,3,1,24.1597069,990,27.5223376623,1001,25.8503113164,1991
WI,2020,3,2,24.09929098,1044,34.4012008282,966,29.0503581011,2010
WI,2020,3,3,16.00005627,1067,20.1776239476,1069,18.0907958989,2136
WI,2020,3,4,21.17861006,1108,23.6605965909,1056,22.3897827849,2164
WI,2020,3,5,18.02444646,1147,28.3963542643,1067,23.0230126873,2214
WI,2020,3,6,18.50804962,1128,29.6989590747,1124,24.0935657066,2252
WI,2020,3,7,24.58711295,1053,34.855754386,1140,29.92512081,2193
WI,2020,3,8,23.44360112,983,25.6758484848,990,24.5636846938,1973
WI,2020,3,9,15.61643698,1030,19.5029453441,988,17.5192468233,2018
WI,2020,3,10,15.6940556,1154,24.7283555133,1052,20.002343682,2206
WI,2020,3,11,15.84997823,1384,24.8091465257,1324,20.2303101441,2708
WI,2020,3,12,14.25364291,1389,22.5543713873,1384,18.3965236213,2773
WI,2020,3,13,15.3555012,1227,26.7453882353,1275,21.1597002288,2502
WI,2020,3,14,11.5696287,1158,19.0952599653,1154,15.325934271,2312
WI,2020,3,15,16.88429774,1189,17.4995528805,1163,17.1885246653,2352
WI,2020,3,16,10.29643472,1279,14.5795871181,1211,12.3795261072,2490
WI,2020,3,17,10.97890711,1336,14.9936602317,1295,12.955001862,2631
WI,2020,3,18,6.257040434,1311,13.0043373494,1245,9.54357590335,2556
WI,2020,3,19,8.936160001,1375,14.5066952455,1283,11.6250225739,2658
WI,2020,3,20,6.891190458,1302,18.961409396,1341,13.0153537557,2643
WI,2020,3,21,6.19168308,1218,14.5287983539,1215,10.3551006952,2433
WI,2020,3,22,8.739202343,1191,16.2988573959,1129,12.4180172373,2320
WI,2020,3,23,7.986960037,1250,13.0707065669,1203,10.4801304714,2453
WI,2020,3,24,6.045711062,1336,16.7552261712,1238,11.1965967284,2574
WI,2020,3,25,7.395853682,1353,16.8514882308,1317,12.0599251055,2670
WI,2020,3,26,11.98143735,1308,15.3918283881,1247,13.6459217432,2555
WI,2020,3,27,9.137446183,1206,19.2717886179,1230,14.2545402696,2436
WI,2020,3,28,8.239951115,1225,8.71075885329,1186,8.47154712396,2411
WI,2020,3,29,7.285584984,1171,15.0401142857,1225,11.2502337297,2396
WI,2020,3,30,6.155583915,1216,19.0720938315,1151,12.436489244,2367
WI,2020,3,31,4.573667968,1265,12.1114032122,1183,8.21629084131,2448
WI,2020,4,1,7.826236318,1270,16.8251699029,1236,12.264656873,2506
WI,2020,4,2,5.515117614,1233,13.5750169492,1180,9.45655201743,2413
WI,2020,4,3,8.543675824,1197,12.1870945946,1184,10.355438875,2381
WI,2020,4,4,6.554845572,1133,13.3242766727,1106,9.89874499021,2239
WI,2020,4,5,6.352641199,1151,12.0938313474,1091,9.14641392509,2242
WI,2020,4,6,7.296996056,1265,12.0123889355,1193,9.58563059839,2458
WI,2020,4,7,7.9542373,1298,20.2294875659,1327,14.1596685773,2625
WI,2020,4,8,6.666554248,1126,15.6217322176,1195,11.2772555292,2321
WI,2020,4,9,7.596272886,1092,11.5211252446,1022,9.49371806599,2114
WI,2020,4,10,5.877325596,1118,14.551143617,1128,10.2335440856,2246
WI,2020,4,11,3.892321134,1090,12.3357003891,1028,7.99042966764,2118
WI,2020,4,12,5.496053152,1054,6.80970643939,1056,6.15350238019,2110
WI,2020,4,13,5.620249611,1122,10.8663203051,1049,8.15508524346,2171
WI,2020,4,14,7.040640119,1203,16.1499828767,1168,11.5280767875,2371
WI,2020,4,15,11.23019669,1220,12.6298222222,1125,11.9016588323,2345
WI,2020,4,16,7.059810299,1160,16.5267147708,1178,11.8297048532,2338
WI,2020,4,17,6.968515115,1091,12.5805231037,1147,9.84473189922,2238
WI,2020,4,18,5.96121927,1058,13.1931914894,1128,9.6929963347,2186
WI,2020,4,19,5.970339843,1030,16.8216570881,1044,11.4326229693,2074
WI,2020,4,20,6.393065247,1119,19.1762239089,1054,12.5934560568,2173
WI,2020,4,21,6.61849651,1144,11.21028463,1054,8.82038216899,2198
WI,2020,4,22,6.57343387,1194,17.6913682277,1089,11.8767323876,2283
WI,2020,4,23,7.032258288,1324,12.0779968701,1278,9.51052650781,2602
WI,2020,4,24,5.664123,1203,14.0946182357,1349,10.1205250662,2552
WI,2020,4,25,5.438032215,996,19.7171239357,1057,12.7897126576,2053
WI,2020,4,26,13.40933968,954,15.1884446764,958,14.3007531667,1912
WI,2020,4,27,7.004785732,980,14.7739209402,936,10.8001461468,1916
WI,2020,4,28,3.622151794,1041,13.4885700099,1007,8.47346192263,2048
WI,2020,4,29,4.798764337,1044,14.2909240246,974,9.38021306632,2018
WI,2020,4,30,7.054167453,1075,15.6505197305,1039,11.2791485393,2114
WI,2020,5,1,5.66451084,971,16.4528624535,1076,11.3353786154,2047
WI,2020,5,2,9.796409121,919,19.7207411504,904,14.7177454647,1823
WI,2020,5,3,4.303804689,891,14.9266630316,917,9.69161503202,1808
WI,2020,5,4,7.593226771,1001,16.8281682641,939,12.0631288648,1940
WI,2020,5,5,4.81657918,991,11.4324148936,940,8.0371310033,1931
WI,2020,5,6,6.985054585,1007,14.9726852846,931,10.822249725,1938
WI,2020,5,7,8.525930993,1015,12.210261233,957,10.313914786,1972
WI,2020,5,8,10.17644759,898,16.0988434696,1003,13.3012045954,1901
WI,2020,5,9,7.496478204,920,12.8300807382,867,10.084185757,1787
WI,2020,5,10,8.187794955,907,18.7246477392,951,13.580984943,1858
WI,2020,5,11,6.151296135,895,15.7421395881,874,10.8897908654,1769
WI,2020,5,12,6.638803644,978,14.9743756906,905,10.6450132575,1883
WI,2020,5,13,6.344861184,973,12.1477927063,1042,9.3456823484,2015
WI,2020,5,14,7.239170146,964,13.5687540984,915,10.3214316236,1879
WI,2020,5,15,7.823104935,934,18.3758384458,978,13.2208943563,1912
WI,2020,5,16,7.877508207,915,14.69,893,11.2423064211,1808
WI,2020,5,17,8.291155057,909,14.6155300546,915,11.4637444884,1824
WI,2020,5,18,9.388454991,932,15.2976345291,892,12.2782511248,1824
WI,2020,5,19,9.023837023,933,13.0006143345,879,10.9529690632,1812
WI,2020,5,20,9.5647389,996,14.2571887967,964,11.8726581349,1960
WI,2020,5,21,8.811624542,948,25.2938629283,963,17.117430699,1911
WI,2020,5,22,7.490172386,928,18.0398016701,958,12.8488918209,1886
WI,2020,5,23,5.461226299,897,19.9740444444,900,12.7297495772,1797
WI,2020,5,24,8.371428583,861,15.7644683258,884,12.1166704928,1745
WI,2020,5,25,9.915995369,874,17.2452291422,851,13.5317506971,1725
WI,2020,5,26,9.361909874,953,21.515021645,924,15.344581838,1877
WI,2020,5,27,11.73527715,1010,17.7038957055,978,14.6715492563,1988
WI,2020,5,28,10.61921892,1037,15.4224130879,978,12.9504962879,2015
WI,2020,5,29,12.63884966,991,17.9068978805,1038,15.3338886215,2029
WI,2020,5,30,11.12062572,991,19.3985568066,977,15.2301474027,1968
WI,2020,5,31,15.25930486,1007,19.2378535607,997,17.2386526916,2004
WI,2020,6,1,10.8384206,1032,21.4129724596,1053,16.1789496687,2085
WI,2020,6,2,4.562678572,1008,15.8020037629,1063,10.3315837762,2071
WI,2020,6,3,7.429657563,1022,17.0914341463,1025,12.2676258082,2047
WI,2020,6,4,9.889514163,988,18.045249004,1004,14.0001355387,1992
WI,2020,6,5,13.48497339,941,15.391659919,988,14.4615448211,1929
WI,2020,6,6,11.61757586,858,14.4227726218,862,13.0234360976,1720
WI,2020,6,7,10.02954378,811,15.9471378911,863,13.0802508994,1674
WI,2020,6,8,8.867212823,879,20.1584249084,819,14.3133274861,1698
WI,2020,6,9,8.793034719,949,18.0707451404,926,13.3749866391,1875
WI,2020,6,10,8.636855052,973,17.5611252654,942,13.0267571622,1915
WI,2020,6,11,8.853278345,909,19.0302898551,966,14.096474675,1875
WI,2020,6,12,13.02454443,845,21.0397569061,905,17.1695543105,1750
WI,2020,6,13,12.79040477,840,19.3935187424,827,16.0662147611,1667
WI,2020,6,14,13.99005874,852,22.4033449477,861,18.2188032963,1713
WI,2020,6,15,9.098006939,863,16.4606581986,866,12.7857200627,1729
WI,2020,6,16,10.13879258,911,17.3207095344,902,13.7119250085,1813
WI,2020,6,17,13.6155078,955,19.7621503132,958,16.6936486926,1913
WI,2020,6,18,13.08344676,969,20.9686027112,959,17.0055756797,1928
WI,2020,6,19,17.64754644,913,21.8409558068,973,19.8109543477,1886
WI,2020,6,20,14.44682681,895,21.3863214671,927,17.9775137184,1822
WI,2020,6,21,16.32380967,882,22.9392446449,887,19.6408762741,1769
WI,2020,6,22,11.71035111,883,14.6069560316,887,13.1619265707,1770
WI,2020,6,23,11.87420666,958,16.5053435115,917,14.1391413228,1875
WI,2020,6,24,10.22161256,986,25.7009240246,974,17.913882645,1960
WI,2020,6,25,12.24478638,936,26.7452820513,975,19.6429984572,1911
WI,2020,6,26,11.06175224,896,20.306429342,927,15.7626933665,1823
WI,2020,6,27,11.94944694,904,26.8067539267,955,19.5818988885,1859
WI,2020,6,28,15.43107347,885,24.4874971031,863,19.9022940623,1748
WI,2020,6,29,13.55616603,952,18.2869222222,900,15.8551296223,1852
WI,2020,6,30,11.6461784,942,20.3279454927,954,16.0145358928,1896
WI,2020,7,1,14.59665278,968,27.824,960,21.1828837609,1928
WI,2020,7,2,16.05871828,983,22.8311700975,923,19.3383473606,1906
WI,2020,7,3,11.38541113,961,23.9002716298,994,17.7484655222,1955
WI,2020,7,4,12.3413393,896,20.000042508,941,16.2644964686,1837
WI,2020,7,5,12.08965394,838,24.8627486034,895,18.6862608204,1733
WI,2020,7,6,12.09274066,945,18.3051900109,921,15.1590138927,1866
WI,2020,7,7,10.5213142,1012,22.677192429,951,16.4103820532,1963
WI,2020,7,8,11.43883789,1024,23.7784901758,967,17.4320291308,1991
WI,2020,7,9,13.43429158,981,26.2059675785,987,19.8395985976,1968
WI,2020,7,10,15.59555202,942,24.2600988142,1012,20.0830245664,1954
WI,2020,7,11,17.8785903,908,25.4145260916,939,21.709799671,1847
WI,2020,7,12,18.73810207,901,31.4855150215,932,25.2196017267,1833
WI,2020,7,13,15.26853433,962,16.5110352423,908,15.8718449334,1870
WI,2020,7,14,11.98969173,1038,21.133646813,957,16.3760401081,1995
WI,2020,7,15,11.64722933,1007,22.7715020161,992,17.167628782,1999
WI,2020,7,16,12.54587985,932,18.1811288605,939,15.3740459755,1871
WI,2020,7,17,11.99265411,908,25.1172257384,948,18.6963684978,1856
WI,2020,7,18,8.794341965,889,19.0783092325,899,13.9650838965,1788
WI,2020,7,19,15.81380526,904,24.8713765643,879,20.2790913937,1783
WI,2020,7,20,12.38992564,940,16.4932375691,905,14.4026613017,1845
WI,2020,7,21,8.212081234,985,19.3954672395,931,13.6461795488,1916
WI,2020,7,22,9.89930993,1058,23.4607685009,1054,16.6671969252,2112
WI,2020,7,23,13.66261366,1121,22.0141920591,1083,17.766406494,2204
WI,2020,7,24,14.6787207,985,21.6392003763,1063,18.2915087351,2048
WI,2020,7,25,16.65026075,920,28.1210094637,951,22.4806626884,1871
WI,2020,7,26,18.03396941,912,26.4822668113,922,22.2811505463,1834
WI,2020,7,27,14.83324025,932,23.5536414254,898,19.1124316464,1830
WI,2020,7,28,10.31806938,979,18.3874112735,958,14.3089984115,1937
WI,2020,7,29,8.589575939,1014,19.5359187817,985,13.9833466744,1999
WI,2020,7,30,17.4464594,1045,22.9299415205,1026,20.1630468725,2071
WI,2020,7,31,11.52730968,959,22.2581707317,1066,17.1762469052,2025
WV,2020,1,1,25.4429744,390,23.4483149171,362,24.4827792766,752
WV,2020,1,2,25.35508825,397,27.6388055556,360,26.44113611,757
WV,2020,1,3,28.98396963,398,32.55552,375,30.7166104951,773
WV,2020,1,4,37.67804805,415,25.0967362924,383,31.6396490486,798
WV,2020,1,5,25.28002696,369,24.946115942,345,25.1186834009,714
WV,2020,1,6,17.02798343,362,20.6264606742,356,18.8121866318,718
WV,2020,1,7,17.3903925,382,28.3595786517,356,22.6817614295,738
WV,2020,1,8,29.66734024,391,25.7891899441,358,27.8136983095,749
WV,2020,1,9,34.56451991,427,21.0486189258,391,28.103985332,818
WV,2020,1,10,21.52915098,424,28.5158205128,390,24.8765725006,814
WV,2020,1,11,23.20700472,414,24.2582281553,412,23.7313437701,826
WV,2020,1,12,26.04685523,442,32.8046022727,352,29.0427330122,794
WV,2020,1,13,13.53754534,497,25.8607922912,467,19.5074170477,964
WV,2020,1,14,9.265135107,333,20.8200455581,439,15.8358678635,772
WV,2020,1,15,14.08228467,302,17.3031174089,247,15.5313660662,549
WV,2020,1,16,25.16863875,382,24.8231662269,379,24.9965834461,761
WV,2020,1,17,23.28634741,397,33.4024731183,372,28.1799738905,769
WV,2020,1,18,17.78837685,382,22.2288251366,366,19.9611095678,748
WV,2020,1,19,26.39683812,408,21.3354722222,360,24.0243228554,768
WV,2020,1,20,12.8770532,414,30.9891472868,387,21.6278402307,801
WV,2020,1,21,19.16077295,427,17.5481472081,394,18.3868697316,821
WV,2020,1,22,19.05171295,432,19.3023913043,414,19.1743853362,846
WV,2020,1,23,22.52758127,430,26.2666747573,412,24.3571614562,842
WV,2020,1,24,27.16179482,429,26.2313432836,402,26.7116846905,831
WV,2020,1,25,19.68233898,419,25.0825268817,372,22.2219975128,791
WV,2020,1,26,21.21517083,439,21.7900431034,464,21.5105647778,903
WV,2020,1,27,25.41469759,430,19.7838337802,373,22.7991157705,803
WV,2020,1,28,19.13297834,413,24.8059278351,388,21.8809239131,801
WV,2020,1,29,15.41138175,427,23.2067764706,425,19.299929586,852
WV,2020,1,30,27.09673931,460,21.7437470167,419,24.5450854182,879
WV,2020,1,31,31.64600896,451,23.9797701149,435,27.8821106557,886
WV,2020,2,1,34.11529836,436,27.7659183673,392,31.1093116968,828
WV,2020,2,2,21.20257116,280,21.1942350333,451,21.1974280777,731
WV,2020,2,3,21.40960977,205,11.6826341463,205,16.5461219582,410
WV,2020,2,4,12.60075521,384,24.3285846154,325,17.9766995778,709
WV,2020,2,5,16.61609935,423,22.2788478261,460,19.5661155437,883
WV,2020,2,6,11.8140957,188,24.888042328,378,20.5454593491,566
WV,2020,2,7,14.31448992,196,13.039084507,142,13.778668711,338
WV,2020,2,8,20.66931688,366,27.4240664962,391,24.1582298257,757
WV,2020,2,9,26.00278233,363,19.2359836066,366,22.6054595141,729
WV,2020,2,10,15.77191497,376,16.7998066298,362,16.27611115,738
WV,2020,2,11,15.6591329,346,17.5668870523,363,16.6358814999,709
WV,2020,2,12,17.95355449,377,17.3391768293,328,17.6677163727,705
WV,2020,2,13,33.99861313,447,22.5016402116,378,28.7309091747,825
WV,2020,2,14,16.1730863,405,35.8567213115,427,26.2751441725,832
WV,2020,2,15,21.7816761,358,27.6726190476,378,24.8071875595,736
WV,2020,2,16,23.85034871,344,25.0157478006,341,24.4304962865,685
WV,2020,2,17,22.39576645,411,16.6682051282,390,19.607066181,801
WV,2020,2,18,23.88545889,414,30.4895989975,399,27.126605142,813
WV,2020,2,19,23.7206803,397,30.2140877598,433,27.1082049146,830
WV,2020,2,20,25.51020294,394,23.8234659091,352,24.7143162981,746
WV,2020,2,21,34.01396848,383,27.7363333333,360,30.9723148423,743
WV,2020,2,22,26.85872337,376,21.7935244161,471,24.0420661005,847
WV,2020,2,23,26.48983689,368,23.1283532934,334,24.8904985406,702
WV,2020,2,24,21.63089345,414,23.3015363881,371,22.4204584564,785
WV,2020,2,25,22.47417624,431,24.0981012658,395,23.2507505562,826
WV,2020,2,26,19.88106821,440,28.5816710875,377,23.8959118879,817
WV,2020,2,27,26.08825779,419,20.768546798,406,23.4703151685,825
WV,2020,2,28,32.75095236,399,24.3744736842,380,28.6648652011,779
WV,2020,2,29,38.18330541,360,25.9824873096,394,31.8078116016,754
WV,2020,3,1,30.09764247,386,22.2665299685,317,26.5664011286,703
WV,2020,3,2,25.34317958,412,13.40904,375,19.6566454726,787
WV,2020,3,3,20.45238548,415,24.1312658228,395,22.2464073756,810
WV,2020,3,4,24.4168396,424,32.4545478036,387,28.2523427748,811
WV,2020,3,5,25.97631207,423,24.0316049383,405,25.0250966251,828
WV,2020,3,6,35.87228288,403,25.6748641975,405,30.7609529711,808
WV,2020,3,7,26.78104839,391,23.9478532609,368,25.4073780244,759
WV,2020,3,8,21.89074537,389,30.9135211268,355,26.1959676733,744
WV,2020,3,9,20.34342903,417,27.3898,350,23.5588525496,767
WV,2020,3,10,14.26065541,473,15.9825298329,419,15.0694731042,892
WV,2020,3,11,13.99337721,533,20.0630905077,453,16.7819980253,986
WV,2020,3,12,21.88136781,541,22.4944680851,517,22.1809640692,1058
WV,2020,3,13,27.08522049,431,34.1665828092,477,30.8052753647,908
WV,2020,3,14,21.36018322,382,21.6056267409,359,21.479095803,741
WV,2020,3,15,23.84622255,368,27.4837101449,345,25.6062971927,713
WV,2020,3,16,19.67388334,394,21.8047,400,20.7473426146,794
WV,2020,3,17,14.6727027,407,18.6961167513,394,16.6517602983,801
WV,2020,3,18,16.61282829,396,20.437627551,392,18.5155203082,788
WV,2020,3,19,19.66609657,415,21.7581510417,384,20.6715395201,799
WV,2020,3,20,16.83798561,417,20.1018357488,414,18.4640192532,831
WV,2020,3,21,13.50552832,407,19.7134265734,429,16.6911603185,836
WV,2020,3,22,8.415940831,372,21.228719346,367,14.7789851003,739
WV,2020,3,23,5.04697788,407,21.1124619289,394,12.9493508079,801
WV,2020,3,24,14.62667437,433,16.8682687339,387,15.6845975637,820
WV,2020,3,25,12.2716473,431,20.0340149626,401,16.0128845989,832
WV,2020,3,26,10.76027364,402,27.9531937173,382,19.1374362287,784
WV,2020,3,27,15.91983044,413,22.2845501285,389,19.0069575707,802
WV,2020,3,28,12.40859295,398,18.5755769231,364,15.3545013046,762
WV,2020,3,29,10.44599493,392,20.9126790451,377,15.5772561932,769
WV,2020,3,30,8.671045187,421,17.7672474747,396,13.0799755492,817
WV,2020,3,31,8.073049729,423,14.9982820513,390,11.3951168947,813
WV,2020,4,1,10.90587335,458,15.495207824,409,13.0708535113,867
WV,2020,4,2,17.62039995,400,13.0238383838,396,15.3336683166,796
WV,2020,4,3,18.06197379,380,26.6568716578,374,22.3252255175,754
WV,2020,4,4,10.41786934,352,12.2928285714,350,11.3526780736,702
WV,2020,4,5,4.37159296,339,12.4654666667,375,8.62257704964,714
WV,2020,4,6,10.65049359,385,12.1724512535,359,11.3848790755,744
WV,2020,4,7,13.09116289,430,13.0450677507,369,13.069874897,799
WV,2020,4,8,11.76418038,366,22.8297201018,393,17.4937681411,759
WV,2020,4,9,8.691011148,356,16.1161755486,319,12.2000888425,675
WV,2020,4,10,8.994521766,345,15.7590789474,380,12.5400827714,725
WV,2020,4,11,8.544657137,350,16.0297689769,303,12.0178407319,653
WV,2020,4,12,11.27035251,312,12.5288888889,306,11.8935112995,618
WV,2020,4,13,9.313224047,366,10.8957017544,342,10.0776412446,708
WV,2020,4,14,7.228726821,377,23.5329131653,357,15.1586921138,734
WV,2020,4,15,11.08057374,366,19.2660277778,360,15.1394765687,726
WV,2020,4,16,11.31324175,364,15.3637853107,354,13.3103064025,718
WV,2020,4,17,8.968942836,350,29.3817784257,343,19.0722655016,693
WV,2020,4,18,8.4506441,326,13.66,326,11.05532205,652
WV,2020,4,19,6.953333339,336,18.1002572347,311,12.3114374063,647
WV,2020,4,20,4.488483975,343,17.6299107143,336,10.9914580316,679
WV,2020,4,21,6.917272748,341,12.0603571429,336,9.46982275786,677
WV,2020,4,22,11.19834708,363,12.4900877193,342,11.8249787093,705
WV,2020,4,23,8.64449581,367,12.9980636605,377,10.8505375837,744
WV,2020,4,24,4.166749236,323,16.3095770393,331,10.3124311976,654
WV,2020,4,25,8.029903499,311,14.24,320,11.179239284,631
WV,2020,4,26,12.7939726,292,12.3844599303,287,12.5909844546,579
WV,2020,4,27,6.959141925,303,13.2771571906,299,10.0971594739,602
WV,2020,4,28,6.991003299,309,15.494012945,309,11.242508122,618
WV,2020,4,29,9.113199967,325,18.6123584906,318,13.8110730782,643
WV,2020,4,30,13.20884147,328,12.6468831169,308,12.9366981166,636
WV,2020,5,1,11.87480648,310,20.1371732523,329,16.1288263049,639
WV,2020,5,2,10.62513153,304,17.9835472973,296,14.2552833085,600
WV,2020,5,3,12.04273314,311,16.0971333333,300,14.0334369992,611
WV,2020,5,4,10.31006064,330,14.2812101911,314,12.2463043652,644
WV,2020,5,5,10.47133327,300,14.4842809365,299,12.4744573973,599
WV,2020,5,6,10.42768159,289,12.6185664336,286,11.51740866,575
WV,2020,5,7,10.1816666,306,18.8648859935,307,14.5303588574,613
WV,2020,5,8,10.35149513,301,23.29778157,293,16.7374579699,594
WV,2020,5,9,20.35698893,269,19.5806737589,282,19.9596733615,551
WV,2020,5,10,11.84242306,260,17.3907553957,278,14.7094051963,538
WV,2020,5,11,7.652836908,282,20.0941666667,288,13.9389824703,570
WV,2020,5,12,11.50529041,310,14.6541463415,287,13.0190620219,597
WV,2020,5,13,15.07901061,283,23.4811671924,317,19.5181500044,600
WV,2020,5,14,14.56074814,294,18.2244444444,270,16.314645307,564
WV,2020,5,15,15.20892089,278,21.4793939394,330,18.6123026438,608
WV,2020,5,16,9.686678432,283,22.3408,300,16.1982332697,583
WV,2020,5,17,10.58077195,285,15.8648096886,289,13.2412021006,574
WV,2020,5,18,10.34347222,288,16.5528621908,283,13.4209807344,571
WV,2020,5,19,14.70601974,304,29.5757239057,297,22.0542762079,601
WV,2020,5,20,12.39501677,299,24.5145045045,333,18.7807595162,632
WV,2020,5,21,11.82563763,298,24.0945666667,300,17.9806187521,598
WV,2020,5,22,16.65857671,267,34.6511371237,299,26.1634805328,566
WV,2020,5,23,15.49666669,264,24.6594736842,247,19.9256555894,511
WV,2020,5,24,15.48749989,260,21.479887218,266,18.5178706681,526
WV,2020,5,25,10.19192592,270,27.1103474903,259,18.4752362919,529
WV,2020,5,26,11.35468741,288,17.6010033445,299,14.5363713357,587
WV,2020,5,27,17.63027402,292,16.0167326733,303,16.8085882586,595
WV,2020,5,28,16.28305555,324,18.7130536913,298,17.4472668781,622
WV,2020,5,29,13.67540976,305,19.1165178571,336,16.5275350652,641
WV,2020,5,30,15.51098356,305,24.0771428571,301,19.7657920558,606
WV,2020,5,31,22.46097721,307,21.9534201954,307,22.2071987027,614
WV,2020,6,1,12.40334379,320,17.3820065789,304,14.8288461744,624
WV,2020,6,2,9.131792437,318,19.8733653846,312,14.4514285634,630
WV,2020,6,3,16.21948982,294,20.3400331126,302,18.3074161193,596
WV,2020,6,4,19.34446365,289,20.9952307692,260,20.1262477138,549
WV,2020,6,5,17.90869565,276,25.0715862069,290,21.5787279141,566
WV,2020,6,6,16.32151155,258,22.2650362319,276,19.3934456552,534
WV,2020,6,7,20.8020319,251,19.8422900763,262,20.3118713585,513
WV,2020,6,8,15.27606785,295,18.8476190476,252,16.9214625516,547
WV,2020,6,9,15.55053682,298,23.188974359,312,19.4574097908,610
WV,2020,6,10,11.75922579,310,20.6778214286,280,15.9917796524,590
WV,2020,6,11,18.0042103,304,24.1705084746,295,21.0410349436,599
WV,2020,6,12,28.95022475,267,23.8155172414,290,26.2768581836,557
WV,2020,6,13,20.97769528,256,20.4554166667,264,20.7125384455,520
WV,2020,6,14,19.5271187,236,24.6224137931,232,22.0529914812,468
WV,2020,6,15,14.39875935,266,39.9835379061,277,27.4502946355,543
WV,2020,6,16,10.4949091,275,22.5010344828,261,16.3411753778,536
WV,2020,6,17,10.75603342,300,23.9425259516,289,17.2261460543,589
WV,2020,6,18,22.0955281,322,20.1772964169,307,21.1592846553,629
WV,2020,6,19,21.28637816,312,25.0756065574,305,23.1594975461,617
WV,2020,6,20,22.5664669,317,31.3439661017,295,26.7974509923,612
WV,2020,6,21,20.75721161,312,24.0772438163,283,22.3363193652,595
WV,2020,6,22,24.55284797,316,29.0629794521,292,26.7188979581,608
WV,2020,6,23,21.02180421,327,19.0488198758,322,20.0429121366,649
WV,2020,6,24,23.29544248,305,23.1884246575,292,23.2430987544,597
WV,2020,6,25,17.09122812,285,26.5706343284,268,21.6852260655,553
WV,2020,6,26,21.40524716,263,29.1561678832,274,25.3600931156,537
WV,2020,6,27,18.95260537,261,33.454122449,245,25.9740909122,506
WV,2020,6,28,29.96902875,278,20.5667054264,258,25.4432835681,536
WV,2020,6,29,15.96486392,294,24.5755755396,278,20.1497901966,572
WV,2020,6,30,23.48144376,284,31.3621649485,291,27.4697739615,575
WV,2020,7,1,28.56459638,285,32.3993312102,314,30.5747912659,599
WV,2020,7,2,18.18689428,293,27.2181318681,273,22.5429505725,566
WV,2020,7,3,18.75993185,294,37.2724041812,287,27.9046470979,581
WV,2020,7,4,16.34824807,274,28.2210071942,278,22.3276448753,552
WV,2020,7,5,17.47985122,269,23.0249626866,268,20.2472439072,537
WV,2020,7,6,16.9760692,318,26.897641791,335,22.0660030714,653
WV,2020,7,7,11.17664473,304,23.9622,300,17.5270860893,604
WV,2020,7,8,21.25406934,317,19.7734589041,292,20.5441543198,609
WV,2020,7,9,17.58012971,308,33.7447648903,319,25.8042423456,627
WV,2020,7,10,21.47119123,277,19.4986738351,279,20.4813848394,556
WV,2020,7,11,16.43119457,293,36.3691119691,259,25.7861232047,552
WV,2020,7,12,31.2110291,272,35.7923722628,274,33.5100914198,546
WV,2020,7,13,22.34094579,296,22.1861397059,272,22.266813299,568
WV,2020,7,14,19.09711807,288,20.4614181818,275,19.7635168813,563
WV,2020,7,15,18.1074679,312,26.8594771242,306,22.4409870304,618
WV,2020,7,16,21.37714748,305,23.9546925566,309,22.6743159306,614
WV,2020,7,17,22.20516023,281,22.9493770492,305,22.5925085745,586
WV,2020,7,18,22.82536396,261,26.5316923077,260,24.6749711969,521
WV,2020,7,19,16.22496443,282,23.7572,275,19.943752189,557
WV,2020,7,20,15.183484,310,36.3432432432,296,25.5189439604,606
WV,2020,7,21,19.45485512,311,27.8848805461,293,23.5442548714,604
WV,2020,7,22,18.45826796,306,21.0779661017,295,19.7441430878,601
WV,2020,7,23,23.45056027,339,29.3269400631,317,26.2902133103,656
WV,2020,7,24,26.17284234,292,33.3355873016,315,29.8899175672,607
WV,2020,7,25,23.14235531,259,25.574765343,277,24.3994030323,536
WV,2020,7,26,25.43802468,243,22.2487136929,241,23.849958672,484
WV,2020,7,27,15.70170499,305,21.1901694915,295,18.4002000366,600
WV,2020,7,28,13.23699683,313,27.9902941176,306,20.5302261838,619
WV,2020,7,29,20.90921379,318,30.3657195572,271,25.2601697542,589
WV,2020,7,30,26.11023963,292,28.9565140845,284,27.5136110624,576
WV,2020,7,31,15.54197678,258,30.5734172662,278,23.3381343456,536
WY,2020,1,1,77.5435165,91,45.0163095238,84,61.9304571514,175
WY,2020,1,2,43.52378082,82,43.272,65,43.4124491649,147
WY,2020,1,3,41.35902454,82,56.143875,80,48.660185261,162
WY,2020,1,4,60.41710565,76,60.1537878788,66,60.2947185169,142
WY,2020,1,5,53.4284816,79,91.2531081081,74,71.7227454013,153
WY,2020,1,6,91.9525011,76,76.0776056338,71,84.2850345823,147
WY,2020,1,7,89.61259163,81,74.7236842105,57,83.462825522,138
WY,2020,1,8,51.16464242,84,37.7765151515,66,45.2738664219,150
WY,2020,1,9,78.95597771,87,32.2938666667,75,57.3531485233,162
WY,2020,1,10,66.53839938,75,64.4239726027,73,65.4954726588,148
WY,2020,1,11,39.81912519,80,22.3819672131,61,32.2753901787,141
WY,2020,1,12,49.13649344,77,30.9750793651,63,40.9638571063,140
WY,2020,1,13,45.10838761,93,42.4979166667,72,43.9692730165,165
WY,2020,1,14,42.80499984,52,56.8222535211,71,50.896260095,123
WY,2020,1,15,98.66249931,48,30.5689473684,38,68.5746507777,86
WY,2020,1,16,42.48836032,61,22.3763793103,58,32.6858821808,119
WY,2020,1,17,28.64954546,66,45.3047435897,78,37.6711111136,144
WY,2020,1,18,24.56810811,74,38.105,68,31.0505633813,142
WY,2020,1,19,65.10229836,87,43.922987013,77,55.1583533983,164
WY,2020,1,20,67.63337343,83,26.5350819672,61,50.2236805187,144
WY,2020,1,21,41.87037029,81,32.8626315789,76,37.5099362643,157
WY,2020,1,22,56.07033252,90,60.6527058824,85,58.2960567246,175
WY,2020,1,23,55.00619643,92,49.055,66,52.5202536175,158
WY,2020,1,24,43.57576485,85,26.2732,75,35.4651875766,160
WY,2020,1,25,42.38899982,90,45.898375,80,44.0404704929,170
WY,2020,1,26,39.23252849,87,35.2467741935,93,37.1732221035,180
WY,2020,1,27,37.79023775,84,32.9549315068,73,35.5419743376,157
WY,2020,1,28,33.4321501,93,87.8695588235,68,56.4243475733,161
WY,2020,1,29,40.26764224,106,46.5071084337,83,43.0077252775,189
WY,2020,1,30,80.94085654,105,24.962688172,93,54.6480804884,198
WY,2020,1,31,64.34090035,100,61.9854878049,82,63.279670522,182
WY,2020,2,1,42.07244925,98,56.9472727273,99,49.5476143477,197
WY,2020,2,2,50.71872686,55,45.908375,80,47.86814798,135
WY,2020,2,3,48.19472779,55,12.4473333333,45,32.1084002845,100
WY,2020,2,4,48.09980182,101,21.1197297297,74,36.6910856218,175
WY,2020,2,5,50.35831484,89,38.4279166667,96,44.1674055176,185
WY,2020,2,6,61.71542954,35,55.921875,64,57.9701013525,99
WY,2020,2,7,46.51886326,44,16.5175,32,33.8867103084,76
WY,2020,2,8,42.03868117,91,65.8948101266,79,53.1247646263,170
WY,2020,2,9,72.2731818,88,30.4272093023,86,51.590689646,174
WY,2020,2,10,42.16524997,80,48.1406944444,72,44.9957236684,152
WY,2020,2,11,33.12769256,78,22.5934615385,78,27.8605770492,156
WY,2020,2,12,42.4485106,94,18.8786567164,67,32.6399378658,161
WY,2020,2,13,58.92991883,123,24.3223076923,91,44.213598206,214
WY,2020,2,14,51.72383029,94,53.5786021505,93,52.6462569372,187
WY,2020,2,15,28.31500008,76,39.0890625,96,34.3284302679,172
WY,2020,2,16,62.47590878,88,27.0171428571,77,45.9284846827,165
WY,2020,2,17,33.09418575,86,48.3541666667,84,40.6344116147,170
WY,2020,2,18,30.08651674,89,23.3347560976,82,26.8488303501,171
WY,2020,2,19,42.85260871,92,27.0419148936,94,34.8622580716,186
WY,2020,2,20,75.06613831,101,13.2080722892,83,47.1627715723,184
WY,2020,2,21,49.29877544,98,48.7267605634,71,49.0584614978,169
WY,2020,2,22,51.22929274,99,40.0486178862,123,45.0345945102,222
WY,2020,2,23,34.29913452,104,52.2425531915,94,42.8177272226,198
WY,2020,2,24,25.08775493,98,27.3583333333,78,26.0940339951,176
WY,2020,2,25,66.68970585,102,34.9192553191,94,51.452857126,196
WY,2020,2,26,25.1264773,88,47.762173913,92,36.6958333467,180
WY,2020,2,27,35.68677096,96,23.6426582278,79,30.2497143552,175
WY,2020,2,28,67.59359474,89,52.2022891566,83,60.1663949527,172
WY,2020,2,29,59.73044448,90,32.1869512195,82,46.5992442047,172
WY,2020,3,1,53.75978305,92,26.893625,80,41.2638955849,172
WY,2020,3,2,31.42519997,100,42.1539759036,83,36.2912568142,183
WY,2020,3,3,37.80010294,97,40.642804878,82,39.1023462859,179
WY,2020,3,4,45.3213001,100,40.673258427,89,43.1325397354,189
WY,2020,3,5,48.05688697,106,57.9575,88,52.5478866949,194
WY,2020,3,6,32.85945605,92,41.758172043,93,37.3328646303,185
WY,2020,3,7,57.68329574,88,33.9413333333,75,46.7590799087,163
WY,2020,3,8,41.82160032,75,42.1876470588,68,41.9956645035,143
WY,2020,3,9,57.71225006,80,34.1987951807,83,45.7391411337,163
WY,2020,3,10,76.53175235,97,52.2101351351,74,66.0066080582,171
WY,2020,3,11,46.64284663,130,39.9760416667,96,43.8109294774,226
WY,2020,3,12,32.69054058,111,42.2211711712,111,37.4558558756,222
WY,2020,3,13,43.70758208,91,32.9283333333,96,38.1738501031,187
WY,2020,3,14,20.09885065,87,24.2907894737,76,22.0533742733,163
WY,2020,3,15,26.29989218,93,50.2388043478,92,38.2046485013,185
WY,2020,3,16,17.86112345,89,53.0589130435,92,35.7517126356,181
WY,2020,3,17,30.91070768,113,28.7303157895,95,29.9148556146,208
WY,2020,3,18,46.38779817,109,47.6183333333,90,46.9443216107,199
WY,2020,3,19,24.36505395,93,61.8918390805,87,42.5030000964,180
WY,2020,3,20,16.2632557,86,40.8536904762,84,28.4138234718,170
WY,2020,3,21,23.26460701,89,49.18075,80,35.5326036917,169
WY,2020,3,22,58.9666251,80,34.8472151899,79,46.9827673459,159
WY,2020,3,23,26.41906652,75,32.0198611111,72,29.1623128503,147
WY,2020,3,24,34.80172389,87,23.636,85,29.2837789444,172
WY,2020,3,25,20.60473089,93,24.0098823529,85,22.2307863639,178
WY,2020,3,26,18.11505473,91,61.3230769231,78,38.0572188191,169
WY,2020,3,27,24.22235286,85,15.8545454545,99,19.7201086582,184
WY,2020,3,28,48.81941139,85,21.92,78,35.9473004181,163
WY,2020,3,29,25.23343749,96,15.7170652174,92,20.5764893566,188
WY,2020,3,30,4.72715914,88,49.8810784314,102,28.9676842333,190
WY,2020,3,31,25.47678143,87,17.8359782609,92,21.5496647174,179
WY,2020,4,1,30.10939399,99,37.7439325843,89,33.7236170479,188
WY,2020,4,2,35.59633059,109,18.7237373737,99,27.565625165,208
WY,2020,4,3,20.10458318,96,31.591011236,89,25.6304864069,185
WY,2020,4,4,9.424065903,91,59.1316666667,90,34.1405524706,181
WY,2020,4,5,15.12532612,92,38.9735955056,89,26.8518232212,181
WY,2020,4,6,17.23796097,103,14.9528205128,78,16.2532043089,181
WY,2020,4,7,41.47336732,98,36.6610752688,93,39.1302094103,191
WY,2020,4,8,35.31925921,81,25.7448351648,91,30.253720907,172
WY,2020,4,9,14.03831587,95,32.3171084337,83,22.5615730767,178
WY,2020,4,10,29.2946428,84,25.7004878049,82,27.5192168386,166
WY,2020,4,11,19.50214292,84,23.863375,80,21.6295732029,164
WY,2020,4,12,18.92708882,79,24.1391566265,83,21.5974692394,162
WY,2020,4,13,23.88453589,97,42.800875,80,32.4342936798,177
WY,2020,4,14,21.18072889,96,28.5294444444,90,24.736558997,186
WY,2020,4,15,16.44408606,93,14.3175308642,81,15.4541379516,174
WY,2020,4,16,34.79190478,84,24.5196511628,86,29.5953529501,170
WY,2020,4,17,38.25357107,84,23.141954023,87,30.5652045022,171
WY,2020,4,18,22.86359992,75,48.43328125,64,34.6366906043,139
WY,2020,4,19,31.34191168,68,24.5925714286,70,27.9183332916,138
WY,2020,4,20,26.79232587,86,20.3373684211,57,24.2193708029,143
WY,2020,4,21,23.99025008,80,32.1545833333,72,27.8575658316,152
WY,2020,4,22,30.31924013,79,48.104109589,73,38.8606576991,152
WY,2020,4,23,22.13132497,83,20.6356976744,86,21.3702365237,169
WY,2020,4,24,44.00808189,73,29.7898809524,84,36.4008915794,157
WY,2020,4,25,23.35627068,59,16.9755384615,65,20.0115320171,124
WY,2020,4,26,30.84707717,65,40.7124137931,58,35.4990245207,123
WY,2020,4,27,13.02082212,73,52.5396825397,63,31.3273530497,136
WY,2020,4,28,25.84900006,80,8.49551282051,78,17.282088638,158
WY,2020,4,29,25.83462506,80,43.22328125,64,33.5629167,144
WY,2020,4,30,22.19404766,84,31.3093150685,73,26.4323567098,157
WY,2020,5,1,40.90492745,69,44.8346478873,71,42.8978571004,140
WY,2020,5,2,48.07781295,64,14.9079166667,72,30.5172796235,136
WY,2020,5,3,59.13308821,68,13.141,60,37.5742968616,128
WY,2020,5,4,42.64653364,75,31.386875,64,37.4622303813,139
WY,2020,5,5,28.7498737,79,18.6875342466,73,23.9173027783,152
WY,2020,5,6,44.70373623,91,55.6835365854,82,49.9080346643,173
WY,2020,5,7,42.68269711,89,27.1991139241,79,35.4017264452,168
WY,2020,5,8,20.3623611,72,32.0687012987,77,26.4119463034,149
WY,2020,5,9,27.74567165,67,60.2528333333,60,43.1033858311,127
WY,2020,5,10,56.13531636,79,47.9594117647,68,52.3532652547,147
WY,2020,5,11,32.03464265,84,38.5141975309,81,35.2155150461,165
WY,2020,5,12,66.07759031,83,33.8351111111,90,49.3040462181,173
WY,2020,5,13,35.51139179,79,39.9063855422,83,37.7631478482,162
WY,2020,5,14,30.69441854,86,41.715915493,71,35.678662385,157
WY,2020,5,15,25.05104484,67,47.955875,80,37.5162585325,147
WY,2020,5,16,26.68311478,61,35.8850943396,53,30.961228084,114
WY,2020,5,17,27.95480009,75,71.9590540541,74,49.8092617903,149
WY,2020,5,18,40.66743241,74,31.0845833333,72,35.9416438242,146
WY,2020,5,19,35.14559534,84,26.9860869565,69,31.4658170494,153
WY,2020,5,20,37.7042047,88,100.999565217,92,70.0551667422,180
WY,2020,5,21,29.21463425,82,44.575,72,36.3961039513,154
WY,2020,5,22,30.64279067,86,75.46275,80,52.24277107,166
WY,2020,5,23,29.27098774,81,43.9163076923,65,35.7911644311,146
WY,2020,5,24,23.40723036,65,29.3150769231,65,26.3611536415,130
WY,2020,5,25,25.55000023,69,31.2936619718,71,28.4628572562,140
WY,2020,5,26,26.04837854,74,64.8069444444,72,45.1621918627,146
WY,2020,5,27,47.69871405,70,73.4289393939,66,60.1854410551,136
WY,2020,5,28,24.46644699,76,93.0019480519,77,58.9581697467,153
WY,2020,5,29,38.46208272,72,46.7655844156,77,42.753154066,149
WY,2020,5,30,35.01407886,76,45.5852054795,73,40.1932214319,149
WY,2020,5,31,76.20571359,91,71.5393506494,77,74.0669639089,168
WY,2020,6,1,39.37435287,85,44.2602105263,95,41.9529999664,180
WY,2020,6,2,40.27296696,91,17.8164516129,93,28.9226630074,184
WY,2020,6,3,23.39850588,87,17.2869863014,73,20.6101250722,160
WY,2020,6,4,40.8662336,77,66.8245070423,71,53.3191891027,148
WY,2020,6,5,28.01209708,62,43.4582608696,69,36.1478627402,131
WY,2020,6,6,49.28868865,61,80.3705555556,54,63.8836522404,115
WY,2020,6,7,55.32685237,54,56.2630508475,59,55.8156639644,113
WY,2020,6,8,55.12970948,69,126.312884615,52,85.7208260671,121
WY,2020,6,9,25.21657142,70,51.40109375,64,37.7226119358,134
WY,2020,6,10,48.86058785,68,49.4816666667,60,49.1517185453,128
WY,2020,6,11,59.8592061,63,29.2624242424,66,44.205038638,129
WY,2020,6,12,31.0898382,62,42.3633333333,60,36.6341800689,122
WY,2020,6,13,68.96016413,61,59.1239393939,66,63.8484252908,127
WY,2020,6,14,60.90432448,74,51.3372463768,69,56.2880420386,143
WY,2020,6,15,47.020822,73,34.5303125,64,41.1858394599,137
WY,2020,6,16,48.41749955,64,57.9024193548,62,53.0846823111,126
WY,2020,6,17,18.66815391,65,42.5685454545,55,29.6225000346,120
WY,2020,6,18,56.65907895,76,69.5297368421,76,63.0944078961,152
WY,2020,6,19,73.20818193,66,67.5508974359,78,70.1438194957,144
WY,2020,6,20,113.3593748,64,87.2455172414,58,100.944590059,122
WY,2020,6,21,98.75337788,74,53.0618571429,70,76.5422219661,144
WY,2020,6,22,43.04478913,71,60.6878787879,66,51.5443797681,137
WY,2020,6,23,37.38093345,75,45.6204918033,61,41.0766177114,136
WY,2020,6,24,31.92535719,84,58.1988,75,44.3184905909,159
WY,2020,6,25,37.19905822,85,64.6659459459,74,49.9823896145,159
WY,2020,6,26,55.21666703,78,81.6124,75,68.1557518192,153
WY,2020,6,27,47.43724973,80,44.3104225352,71,45.9670197245,151
WY,2020,6,28,48.59159934,75,31.0043548387,62,40.6324083978,137
WY,2020,6,29,46.052222,81,78.1472972973,74,61.3750321419,155
WY,2020,6,30,29.03545459,77,75.4335443038,79,52.5319230989,156
WY,2020,7,1,50.50049454,81,70.2435555556,90,60.891579285,171
WY,2020,7,2,55.53845206,84,55.2754878049,82,55.4085540545,166
WY,2020,7,3,66.51709262,86,47.5127272727,66,58.2651971403,152
WY,2020,7,4,43.76170487,88,82.2848051948,77,61.7391516882,165
WY,2020,7,5,62.075698,86,75.9197468354,79,68.7040607758,165
WY,2020,7,6,63.05516112,93,68.0745205479,73,65.2624697841,166
WY,2020,7,7,63.14121205,99,53.3378666667,75,58.9156321434,174
WY,2020,7,8,53.34989049,91,64.4057303371,89,58.8163890811,180
WY,2020,7,9,59.06337457,83,29.5576666667,90,43.7135843313,173
WY,2020,7,10,55.06999975,78,52.2230864198,81,53.6196854119,159
WY,2020,7,11,42.82765408,81,91.3605479452,73,65.8335063668,154
WY,2020,7,12,56.66186061,86,101.88076087,92,80.0334270363,178
WY,2020,7,13,46.4654002,100,50.8453521127,71,48.2839767251,171
WY,2020,7,14,65.23820071,100,49.9583333333,78,58.5425284888,178
WY,2020,7,15,68.76070709,99,104.622337662,77,84.4501704654,176
WY,2020,7,16,84.63941211,102,100.447954545,88,91.9612633433,190
WY,2020,7,17,68.61988442,87,68.8057142857,84,68.7111692663,171
WY,2020,7,18,76.46817158,82,110.308732394,71,92.171961239,153
WY,2020,7,19,85.87987742,82,78.9041666667,72,82.6185061587,154
WY,2020,7,20,53.43714296,91,74.5670238095,84,63.5794857678,175
WY,2020,7,21,53.04393591,94,47.03875,72,50.4392769611,166
WY,2020,7,22,61.79113472,97,51.8486868687,99,56.7691840196,196
WY,2020,7,23,71.00762882,97,87.2787912088,91,78.8835638061,188
WY,2020,7,24,78.03381401,97,51.825375,80,66.1881918586,177
WY,2020,7,25,66.23627631,94,59.1266666667,87,62.8189501278,181
WY,2020,7,26,55.39688366,77,91.3771232877,73,72.9072669455,150
WY,2020,7,27,56.57010283,97,59.4783529412,85,57.9283515083,182
WY,2020,7,28,75.87075239,93,110.060784314,102,93.7547690886,195
WY,2020,7,29,76.33216512,97,80.8384210526,95,78.5618230033,192
WY,2020,7,30,104.6391664,96,99.0524137931,87,101.983169259,183
WY,2020,7,31,64.0813258,83,71.9095121951,82,67.9716972206,165
